--------------------------------------------------------------------------------------------------------------------------------------------------------------------------------------------------------
--------------------------------------------------------------------------------------------------------------------------------------------------------------------------------------------------------
--------------------------------------------------------------------------------------------------------------------------------------------------------------------------------------------------------
----B-o------B-o---o---B--??----B-----------o--Bo------M-----o?-B----Mo--M-E----B-------o-E--M-M--MM--------------M---Mo-E---?--E-?---?----o-o---E?--o-------M---?--B----oM--------o-B--E?-----?--------
---o-?o------o-o-------------M-Bo---M---E--?-B---------------MoMoB-B----?-B-oo?---oo-oB?--?-?--o----oB-----B--------B?--o-BB---BM-o---o----o----B-o-B-BM------B--ooo--Mo----o----B------B---B-oo-o------
-B-oo-----M--EB----o--------?--o-?-E--MM--B---?-B-M-oM-oB-------ooo--o-----?o----------------------o--o----------o---o-?----oooo---?----o--o-B?----E-Mo-------o-M-M-?------o----?-?-M-------o----B---BB-
-----?----o-?---o------o----o--B---B-?oo-?----o-----Bo--o-o---?--?o-o-----------o---E--o-oo--------o-B------M-------?-------o-------o--?--B-?-o-o?-M----M??-?--o--------?---------------M--o-Bo-oo------
-o-B--ooBo-----M--------B--T-------o-----------Bo-oM-oME--Bo-B------------Mo--E?--B-----?-o--o--ooM---o--M---------------MMB---E--?---?-MB-o----oo-----o----o--?--?------------------?--------?Mo------v
--B-?o-----B--o---B--o-o-oE---MB--M-------?--------o--o-M?-B--o-?--------Mo?-o-o-M-M-?--oBEoB?--ooo-B---M-Mo?TM---------?o------M---M----o-oM---o--oM-?BMBo-?-oo----------o------oo----M----?o---ME---Bf
-B-----M-------------B----?------E-?-o--------MMBo---M-------o-E-----?--------?-----o-----M--oM---oB-----M-------o--M?o---Bo-B-?-----o-o--o---o------------o-------------------B-MoB----M-?B--Moo--B---f
----?o--o----B-o--o?-----Mo------BEo-M-?o-o-----------o-o--?---B--M--------M----M--oM--o--o--E-o--o---Mo----?o----?-------o-B-o-o-oBM---M----M----o---MM-M-B-M-----M--?B-BBo----------B?--o-----?------f
-----o-o-B-M---B-------B-o-ooMo-B---?-B--M---------oM---o-----E----o----?o-oBo--o-o-----oB-B-B?M--------B----E-Boo-MB?------o---?-o-oBE---o-?-o----T-------------o-o--o-B---M--M-o---------B-Boo-?B?--?f
--?------o-------?B----------oo-----o------o-o--------M-BB?---M-?M-?--o------M--?---??-M----------o---?---o----o--------?--o-MoB-?-o--B----------B--M-o----MBM-?----oB----o-------oB----?M--------o----f
------o----------------o-------------------o----o-------------------------------o---o-------o--------------o----oo-o----o--o---o------------------------o----------ooo-----o---E------X---o---EoT-oT---f
mo---------------------E---E-----------o--o-----------------oo--E-E---o-------o----o--E----TX?-E-----oT-T----------o---X-X--o-T---------XX-T---o-o-X----oo---o----X-------o---------ooX-----o---Xo-Xo--X
XXXXXXXXXXXXXXXXXXXXXXXXXXXXXXXXXXXXXXXXXXXXXXXXXXXXXXXXXXXXXXXXXXXXXXXXXXXXXXXXXXXXXXXXXXXXXXXXXXXXXXXXXXXXXXXXXXXXXXXXXXXXXXXXXXXXXXXXXXXXXXXXXXXXXXXXXXXXXXXXXXXXXXXXXXXXXXXXXXXXXXXXXXXXXXXXXXXXXXXX
