--------------------------------------------------------------------------------------------------------------------------------------------------------------------------------------------------------
--------------------------------------------------------------------------------------------------------------------------------------------------------------------------------------------------------
--------------------------------------------------------------------------------------------------------------------------------------------------------------------------------------------------------
---o---oo------?-oE-----o-------o-o-M-o---------MM---o-o-?---o-o----E-ooo--??--oMM?-oo-?-T----M-o-------o--?---o----Mo--B----?-o---M-------?--o?----M--M--o-----------o----?------Boo--B--?M-B------M---
-?---B----------B-?------M-B----?-------------?----oB--------B-----?----------M-o--?o----|-------B--B-----o---?--B---M-oo------Eo-o--B--oo--------BE----o--o----M--------B--B?-MB---MB-o--o-B--B------o-
---?o---o------B-?--Bo-?-o--E-?------BM--E----------o--o---MB-?M--oo-E----?--o---?----?-?--B---oMo----------B----------M--------M-B---B---oBB----T---B----M-----o-oB---M--E-ooB---------M--------B?-?---
-----M-----BoB?-?-----M------o--o?MBo---EB----o------oBM-?----------------o-Mo--E------M------o-----?------------M----o--B-------o-BB---oo------M-o-M-?--E---B----Mo-?-----?-Bo-------o-----------------
------o-B-------------------o-------o-------M---BMB-------M-------E--M---o----o-MB--------BTM--------?------?---o---------B--o-----o-M-------MB----o---o-?oo----M-----E--oB-M-oo--------o--M-?-o---M-M-v
-B-----MoB----oM-?------M----B-B---B-o------------oB--Bo--oB--oo-?-----------?o-----MBM-o-o---M--B-B-oM---EB--E-MB--M----------o--B---o---?----oo-o----o---o--MM-?-M-?BE-oo----oo--M-o-M?--o?--o-------f
-o--------------------?M-----------------M-------o-oo---o-oooo-?--E-----MB--Mo----o-o-----oo-o----oo----o----B-----o-M-Bo------o----M----------M--o--?-MMo-Bo-----o-B-o-o--?-MM-B-o-----------Bo-------f
--o------E----o-?-o-------M----M------------?---o--E-M---B------?-M-o---o--?-?-M?M--M------o---B---Mo-M----?---MB---M-?-------o------oo----M------o?------------o--Moo--B-o-------MB---B--B-B--o-------f
-?---------M-M-o---M----o---Booo--B--------------o--oo--E----------M------oo?-----B------o---------o-------------o-M---M?--------B??Mo--B-o-M---------?--oMo-B------Mo-o----o--------B-------Mo----o-B-f
-o-M----Mo-------M--o-o--M-o-o-o-o-o------------M?EM----B-M?-BoB---o--M-?oMM----?--Mo--o-T--Mo?----o-----ooo-----E------o??B?-o-?-o--o-?o-o-ooB--MB-----------?-oMMM-----B?-------o--o---B------B---Mo?f
---------o------------------o----------------------------------------------------------------E---------------------------------o-o-o-----------o-----------oo--------------o---T-----------o-----T-----f
mXo---X----o-------EX-T---o--oEX-T-oo---------Eo-------o--T-------o-------------oo----T----E-X--oB-E-------------o-E--T-XE-------X--EE-Eo---Eo----E---o-ooEo------T--------------E--E---o-o----E-Xo----X
XXXXXXXXXXXXXXXXXXXXXXXXXXXXXXXXXXXXXXXXXXXXXXXXXXXXXXXXXXXXXXXXXXXXXXXXXXXXXXXXXXXXXXXXXXXXXXXXXXXXXXXXXXXXXXXXXXXXXXXXXXXXXXXXXXXXXXXXXXXXXXXXXXXXXXXXXXXXXXXXXXXXXXXXXXXXXXXXXXXXXXXXXXXXXXXXXXXXXXXX
