--------------------------------------------------------------------------------------------------------------------------------------------------------------------------------------------------------
--------------------------------------------------------------------------------------------------------------------------------------------------------------------------------------------------------
--------------------------------------------------------------------------------------------------------------------------------------------------------------------------------------------------------
-----B-M---?M--o-------B--M--o-----B------------BM---------B--B---?-?------------------B-----?--B---B-?-------------o---B----o-----o---o-o---B-?-----B--M--?------------------B?---?--?-B-----o----B-M?-
---M-----------?--?-----B-----M-------B-M-B--?-B-------------------------------M----M---o------------o-?B--B----M--o--?--o---M--?---M------------------M--M--B-------?o---------o---------M---o---M-----
----M---BM-------?--B-M----?---o------------?---?-Bo-?-----M?--------?-------?---?------o--------M-?-----o--o----------M------------------?----o-o--------------B?---------------B-----oB------?o-o-?---
---o------------?------o--B-----B---B----Mo----o-o---------o------BBB-----MMM-------B----?-o-M-----o--MB---oB------B---o-o------M---?------o--?--o-------o--B----------o--------------------------------
----------M-B-------M?---?--?M--o----o-o-------B-o----------------------?----o-?----------M-----?o---M-oM---------------?--------o-----?------------o--?--M-----o-----?-------o--B----?----------oE--?-v
-------------M----B-----------o---B-o-----------Bo-------Mo--?o---o---------------?---------o------?---?-----?------------M----?M-------B--M?-----------M--B------B-----------B-?-----------------MB--Bf
-oB----------o-?-?------oM-------o---------------o-----o----?--B---?------------M-o-------M------o--M-o--M-M-----o----o----------?----------------M--?-B----MM---o----------?-------BMo-o--B-----------f
------------B?---------------------M---?-X--------?--?--B--?o-o---------B----o-------------B---B---------oM------ooBB-------B-B--o?-----Mo------B-------?------?-oB--?---o-o----B---o---------MB--?----f
------o---?-----oBB---M------o--o----M----M----B------------M-M----o---B----------------------B---------------M--o---------?---o--o-M---------?-----o------M-?--------B------------------M-----o-o-----f
-o--M--------?-----------oo------o-----oB----------------?-M----------------o----B--------o--B--------o-------------o-oB--M---?--o-----oB---o-----B---?-------------M------------B--?------oo----B-----f
--------------------------------o-----------------------o------------------o---------------------------------------o----------o---o--------oo----oo-------o------oo--------------------------------o---f
m--------o---E------------o-------------E-------o------------o---o---o--------o---T----------------o---------E--------To------o----------------X-------------------------------X----------------o---X--X
XXXXX-XXXXXXXXXX-XX-XXXXXXXX--XXXXXXXXXXXXXXXXXXXXXXXXX-XXXXXXXXXXXXXXXXXXXXXXX-XXXXXXXXXXXXXXXXXXXXXXXXXXXXXXXXXXXXXXXX-XX-XXXXXXXXXXXXXXXXXXXXXXXXXX-XXX-XXXXXXXXXXXXXXXXXXXXXXX-XXXXXXXXX-XXXXXXXXXXX
