--------------------------------------------------------------------------------------------------------------------------------------------------------------------------------------------------------
--------------------------------------------------------------------------------------------------------------------------------------------------------------------------------------------------------
--------------------------------------------------------------------------------------------------------------------------------------------------------------------------------------------------------
-----------------------M-----?M-?-M---?------o-o----------o-M----?B-o?----B-o-o-o-------B-----------M-o----?----------M----M------o---------M-----o--------------------o-----M-----o-BoM---------o---oM-
------M---B-----?-M----o--o------?------ooM-?o-----o-M------------------X----B-----oo-?-------Bo--?o-?-o------------------M----------?--------------B---?----------?----oM-M?-------------o------Mo-----
-------------------?--?-M------B---B----B--?--B-?---B-----?--?o--?--------o-----E---------------------?---B?---------B--------------o--B--??--M----o------oB-o-B------?-------MBo?---?---?--------o--B--
------?-o--------??--B-M-----------------------E--------------B---M---o---------------?-B-------o---------------M-M-?----??----------?---------------o-BM----B--o--?---?-?M------o-----?M--B-------B----
--------------?-----------o-------MMo------BM?-Mo--B--------?-----------o--??---B-BM-----?----o--M-------o-------o---?---o---o-M----o------o-------o--?-----------?---?-----B-------------M--M-o?------v
----o---?--------?--BM---Mo?-------------E----------oo----------Mo-B?----B?--o---------X--B--M----?--?-B-------?-o---------?B-------B------M---oo---M---B--M--?---------------------MBM--B----------??-f
----?--oo-?---B----------o--?-M--------?o?---o-------M---E-B--??o----BM-?-----------o---------???-oM----B--Bo----o--------------M----------o-----------------o------B--------------o---------B-M-------f
-o------M----?---------M-o-B--o------o----B--o-o--------MB-o---o-------o---?-----B-B--?-------------B-B------MoB-----------?---B--?-B-------------M----o-Bo---?--o--------------Mo---M-E----o------?---f
--o------o-------oM--M----------?---------ooBo??--??M--?-------B-------------B?--o--oB--------?o----------B--------M-------------------------?-M-----B--B------?------?----------------B----o----o-----f
------Bo--o-------o--------B?--o----o--------M--B----o----M---o-?-----B-o---------M-B---------o------M-------o-B--?----?--------B-B-M----?--------------------------?---------?--?---?--?B---o---------f
----o---------------------------------------------oo---------o-----------------o--------------------oo-----------o---o---o--------------o---------------------------------E---------o-oo------o---o----f
m-oo------------------o-----o--E---------o---EX-----o-E----------------------------o-o------------------Eo--o----oo---o-------------oo------------o----------------o-XX------------------------------X-X
XXXXXXXXXXXXXXXXXXXXXXXXXXXXXXXXXXXXXXX--XXXXXXXXXXXXXXXXXXX-XXXXXXXXXXXXXXXXXXXXXXXXXXXXX-XXXXXXXXX-XXX-XX-XXXXXXXXXXXXXXXX-XXXXXXXXXXX-XXXXXXXX-X-XXXX--XXXXX-XXXX-XXXXX-XXXXXXXXXXXXXXXX-XXXXXXXXXXXX
