--------------------------------------------------------------------------------------------------------------------------------------------------------------------------------------------------------
--------------------------------------------------------------------------------------------------------------------------------------------------------------------------------------------------------
--------------------------------------------------------------------------------------------------------------------------------------------------------------------------------------------------------
-M---E-----------M----TEo?------------?----oEo-EoBo-?M-----oB-B--o-----?-?---oM-------o?--oo---BoM-?--?-T-------------Bo-------o------E--M--------?BE-T-----o---M--B-B-E---M---o----o-E-Bo----------?---
-o?--??--?EBMo-B--EMMo------o-Eo-B-B--o?---E?-ET--oo--o-o------?--Bo---oEo-MB-oB?------oBE---T--o---E-oE-----oM------E----oTM------------o--o-oE---o----E-o--To----o---XE-?o----EEE-M---o-E-?-Eo-TE---o-
-oo------oTo---o---o----M-o--B--------------o---o-M-o-------oooo--oX--T---o-oo--------E----E--X------o--o-M---o---?B--o-o----XE--E---E-o---E?E----M--?M--oB-?---E-------M----------o--?E-B-B-E--T-B-----
-----?---------X------------------o-BM--oo--Mo--EM---MB-XEE-----M-?--TX------o-M--ooE---?---?----E--??o---oM-ME------o-----T---E----X---------B--?oB------o-o-------o--oo-T---o-----B-o------?-?-Mo---T-
-----oM---M--B----------o-E-B?M?-E---o--o----o-?----oo---B-------o---X-?E-oEMB-----T--T?oT--o--B--T--------o---o-ME---B---o|---M------E-M---Mo-------M----M-----?oM-?-o------E------oo-?-M-----o-----X-v
-X--o--Mo?-T---?-MM-?-M------------TE--------E--EToT-------------------o--B?-o-o--o---|-------M---X-o-----E?o--M----oooB-------oBo?--B-------E-T------?T-o--oX-----E----EB-------M--o--oE-M--T--------Ef
------?o--E-?--o----o---?--------------M-----?-M-------o-----TMME--o-----o------?-T-?----M---Bo-TM---Mo--?----B----o-Bo---BT--------To-o----?---B--EB---?--E----E--?--E-?o-o-oo----MEo------?---o-EX---f
-----o--------XE-?-B--------o----EM---EoE-o------M-o-o--o------o---T---o---E-------o-T---o---oE--o--Mo------T--T---------T-----E------BB---------MM-o-?Bo----------o--B-o--??oooM----------T-o---B--MoMf
--o-B---o-XE---------------------?---?--------------?---B----oBo-------o?---EB------o-------B----------E--M-|B------------?-----E?----oo---oo---------o-?T---B-oE?-T-----E?---------oB---o-X--E-?o?E-oof
-B----M-oo----------T-E------B-E--?B-----M--o----MB------B?-E--XX----oM----XT---EM-M-?----M-----M-o-o--?---M--------M--T---MB---B------?---E-------M------------B-E--Mo---oM----E--o--?B-E------o----Mof
--o---o---------o--T-E-------------o---E-o--o----o------E----o---------E-----o---oT---------------T------E-----o----o------o----o--oo--o----EE--------------T---------------E--E-o-oo-------------E-o-of
m-o-------------o--Xo--E--o-TT---ETET--X-TT-T-------o--------ME-----E--X-o-ET-o---|-ET--E-o---?EX-X---o----o--ooo--T-o---E--E-----o-----X-oE--oo----Eo--o-E-|-T---oX-T-T--?--M--X-E-----E-E-o---EXBEoTEX
XXXXXXXX-XXXXXXXXXXXXXXXXXX-XXXXXXXX-XXX-XXXXXXXXX-X-XXX-XXXXXXXXXXXXXXXXXXXXXXXXXXXXXXXXXXXXXXXXXXXXXXXXXXXXXXXXXXXXXXXXXXXXXXXXXXXXXXXXXXXXXXX-X-XXXXXXXXXXXXXXXXX-XXXXXXXX-XXXXXXXXXX-XXXXXXXXXXXXXXX
