--------------------------------------------------------------------------------------------------------------------------------------------------------------------------------------------------------
--------------------------------------------------------------------------------------------------------------------------------------------------------------------------------------------------------
--------------------------------------------------------------------------------------------------------------------------------------------------------------------------------------------------------
--Boo---o-----BB--------E-oo-------?M-------oo----B----------o--B--------o--------B--o-B----------o-?-o---------?--MM-----B---M-?----o-?-M------B---Eooo-M-------o--o---------?--?--MB-----E---B--------
-?-----o--------oE------B------?------E--?---MB--oooB----M--B----?----?--o-M---------??-Mo------------------M-B---M--o--o-o--o---?--E-----------o-M---M--o--o----E-?-M-oo--B?o----?Bo--------?-oo----o--
---o-E-oB-M-B-M--B--o------o--M---M-o-?-----------B-----?-----M--o---B----o---?----oM-o---o--o-M--o?-?--oB-o-----Mo---ooE-M--?----oo----MMM--?o--?------?-M--???------M--Bo--Bo-------o-----ooo---------
-----??--o-------o?M-M-E-E--o--B?--B---oMEo-Mo---oo----o--o--?--o---o--B-----Bo---E---oB----EM--BME-o---?o--o--------?B-?-oB--E-o--?-B-o-o--o-------o--oo--B------T-o----------M--o-?---?--?--o--M---?M-
--------M-M-o----o-o---M-?M----o--?-?------Bo---?-o-B--o----o-oB--BMo-M---o------o?o----BTM-B-M---B-Eo-o-----------o--o?-----o--------o--o-?---------o--EM---M---------?----o-E-?--BoE----B-------o?o--v
-?--E--------?-o-----------B-----o----B-----?-?----M--o-BM----o-----------E--Bo----B---B-----?----oBM------o---?---o--------B----B----Bo--------Bo--o-M-B----o---o-----oo--?--??--o------B-o------B-?--f
----M-B-B------M-o---M--o--o--BE?-------oB------------?---o-?--Bo------o-?MBMo--B-o--M---oM-o--B--?--E--o--?-?-oE-B--o--M--oo-----------Eo-?-----B--M-------B--o-----M---------oo----------------------f
-oo-----o-oM--M-B----o??--M--oo----o-------MoM----M-B?o---o-----E-o--o?----------?--M-------o-M--o--B-Bo--o-----Mo---Mo--o--M-----------?o----o----------M-o----------M-o?-M-----?------?-----oo----B-Mf
-------??--oo-o--?---o-----------o--B-M-------?----?-------o--?------------o-oM--o--------Booo--------------------E-M--BM--o--?-oM-B-?------------??--M-E-------M--Mo--------o-----o----oo----M-oo-?-?-f
---o--o--oM-oBB-------MoMoM--o--?-------?--MMM---M----MM-o-----o-BMo--?--o---M-?o-o-o------------o-o----o-o-B-----BB-o-o---o-----------?-----o----o----M---o---?oB---o--BoB?o---B--o?--BMo--BB----Eo---f
------------------------o-----------------oo--------------------------o------o---oo---------o-o-T---o--oo--------o---o--------o------o-------o--o-o--------o----------o---o----o----------------o--o---f
mo-------o---EET------o-o----o-T------------o---oT----E-Eo----T-oE-E--T-T----EX--X--oo-----E-E-o-To-------------E---o-----Eo-X-------oEo--o--TXE--TT-T-----T--------o-T--E--E----E-----------o----o-XooX
XXXXXXXXXXXXXXXXXXXXXXXXXXXXXXXXXXXXXXXX-XXXXXXXXXXXXXXXXXXXXX-XXXXX-XXXXX-XXXXXXXXXX-XXXXX-XX-XXXXXXXXXXX-XXXXXXXXX-XXXXXXXXXXXXXXXXXXXXXXXXXXXXXXXXXXXXXXXXXXXXXXXXXXXXXXXXXXXXXXXXXXXXXXXXXXXXXXXX-XX
