--------------------------------------------------------------------------------------------------------------------------------------------------------------------------------------------------------
--------------------------------------------------------------------------------------------------------------------------------------------------------------------------------------------------------
--------------------------------------------------------------------------------------------------------------------------------------------------------------------------------------------------------
---?o------EEo-------T-------??--?o--o----?-EM-To---o?--E---?---E---B-----oEoE---o----E-E---oooE-E--??E-E--o---XoMEoE--T--o-----o?oo?o---oo-T-B-----T-?T-M-B-B------EX-----o----M-X?---BM---X---o-------
-----B--oE-T--EM-oE-o-?-----o---oo-?--------------------?E--o-?-?-----oB-----M------X-X-------TMo---o-------Eo--------E-B-E?-E-E--o------B-------o---Bo-o--o--------------M---------B---o--------?------
---?-----ME---B---?--o-----oo-TEB-o----?E?---o-----E-X-o----M-o--M---o--o---o---M---X---E---oM-------Too-E----X----BEE?-oo---B-?---T---o--oX?-o--ToX-o--o----?---T------oT--E-----E-o-E-------oT---???E-
-----T-Mo------X---E-B--o--T-T----M-B--o-o----B---T-o------MoM--?oE-o--M--------oE----------T---oB?--XT-M--?T--M---oM---------------oo-M-o-----?-------oM-----?-M|E-------o------o-oE-B------o--E-------
---o----Xo--E-----BMo-----B-B-----oB-o-M-oE---oo---M-Eo---o---o----------EMT-o-o-M?---?-----|--M--oE-----T-o|--oM-------T---B---o------------E-o--------oo----o-------MBoo------------oM-E-E-E----B--o?v
--B-E-E-----BT-o----M-o-B--?oE--o-----T----B-----EB--B--oo----------B--M--------T----------------EEM----------o-o--Mo--o--TXoooB--o---M---B-B-T---M?-o----E-T----o-?--o-oEoM-----T-T-T--E---------o---of
-----oTM-MM--X--B--?---Eo----T----?----B----o-M-----o-BM----BE-EoBBo----oTo----M----M-----E-----E--------E--?-------o---------o---o-----B---------o-T--Eo-T------B-------M-o-M--?-M----MTE-----B--X----f
--o------ooM--M--B--o-E------------To--o------o--XE-B----?--o---o-----------?TEo--Bo---T-E---B-----E---M-------------o-B?----M------T--------oM------------BB--M----o---?-o-o---o?---E--X------oMM----Tf
--T--B--X-------BoE-----B--E-o---------MoB------E----EB--o-----------?--T-o---X--o---To-----o--o--o----o--E--------EE-----T-----MB------B-----o-?-X--X--------E--TB------?EX?-MB----?---------M--o--Mo-f
--|-E--E--oT-o-E----T-o--M---------o---oo--B-----T-?--------M-ooT---ooo---ME----M-----o-o-o-M----o-M---E-oT---E-M----B-----oo-T----oo-o-o?-M----o--------------E----E---E---------------------o-Eo?-o--f
-E----o----X------------o----T-----E---XEo-o-------------X-----oX--o-----------o-----o-XX---oo----------T-------o--------E-o------X--------------E-o-----oT------oo------------------o-----T-o--T------f
m?oT-o-E--TX-Eo----TEo---Eo--Xoooo-TToM---E----ET-T-----oX----ooXoX-Eoo-o--------o--X-EXX--T--o----X---o|---E----o--T-XX----BEE---X-----T---E---T---T-oE--|--E--?--TEoX--EEo---B-T-----ooE-XE-----X-ooTX
XXXXXXXX-XXXXXXXXXXXXXXXXXXXXXXX-XXXXXXXXXXXX-XX-XXXXXXXXXXXXXXXXXXXXX-XXXXXXXXXXXXXXXXXXXXXX-XXXXX-XXXXXXXXXXXXXXX-XXXXXX-XXXXXXXX-XXXXXXXXXXXXXXXX-XXXXXXX--XX-XXXXXXXXXXXXXXXXXXX-XXXXXXXXXXXXXXXXXXX
