--------------------------------------------------------------------------------------------------------------------------------------------------------------------------------------------------------
--------------------------------------------------------------------------------------------------------------------------------------------------------------------------------------------------------
--------------------------------------------------------------------------------------------------------------------------------------------------------------------------------------------------------
--o---M-B------------M------?---B------------------B--o----M-o-Boo----?---M-------?-?-----B------o-----B-----?------------------?---?B----B--------------------o-----?---------M--o-------?------B--B---
--?---------------------------?-o-----B-------------------B--o---M-----?B--?--------------------BM-------MM?-----o?-----?o-----M---o----M---B----M----??--B----?-o--------B-----?----B--o------o--------
-?oo----B---MB--MM-?-?-?----B--M-o---------?--B------?--------------B-------o----E---B-----?--BM----?--M?----------B------?M-------B--------------M--------o---------------?-----------------B---?M---?-
----------o---M---M----------?----------B-B--?-o--------------?------M-------o---MM----------M---B------------M---M----?------------------------o----o--?-?------M-----o-------M--B-----?-?---M-B-------
--??---------?------B-MBo------M---------M-o----------M-----B-----o------?B--?-------M--?-o--------o--?----------M--?---?B--------o------M------B-----o?---M?--------?--?-------M-----------------?-?--v
-----o?----------B?B-------B--?o-MB-------------?--------?-o---o-----B-------oB-------?-----B----o---o-??---------M?o?-M--?--?-----------------o----o---------o-----------------------------??---------f
-----------o-------oo--------B-M----o------------o-------o------BB----M----o----o--M----?--B----o-----------M--B--------o--------B----M------M---o--------------------o--o-M-?--o-----MB--B-o-B------B-f
-----------??o-----M?-?-??--B-----?---M--------M--M---?-?o---------------------?--?--------------------B---------------B----B--Mo--------?-----o------------B----?o--o----o---M?-o-M-M--M---M------B---f
-----------------------B-----B--M--oM--o---------?---B------?---------------oM--?-----?---M----------??-----?--?-----o------------o------------------?----B?-B----o---o----------M----oMo-----------?o-f
---?B-----M---------M----o--B--o--o---------o---------o------------------------------?------B-------------------------?-o------o-B?-----M-----B-MB------------------------o----B--B-B--------?-M-B-o--Bf
-------------------------o-----------o--------o--o--o-----------------------------------o------------o----------------------------o-------------o--------o------o-----------o------o-------------------f
m--o---------------o-----------------------X-----------E-------o----------------------------------------------------------X----------------------oX--X-----------------------o-------------------------X
XXXXXXXXXXXXXXXXXXXXXXXX-XXXXXXXXXXXXXXXXXXXXXXXXXXXXXXXXXXXXXXXXXXXXXXXXXXXXX-XXXXXXXXXXXXXXXX-XXXXXXXXXXXXXXXXXXXXXXXXX-XXXXXXXXXXXXXX-XXXXXXXXXXXXXXXXXXXXXXXXXXXXXXXXXXXXXXXX-XXXXXXXXXXXXXXXXXXXXXX
