--------------------------------------------------------------------------------------------------------------------------------------------------------------------------------------------------------
--------------------------------------------------------------------------------------------------------------------------------------------------------------------------------------------------------
--------------------------------------------------------------------------------------------------------------------------------------------------------------------------------------------------------
--oEo-------?-----B-------E----?o---------M-Bo---M---?-----M----M--o--o--------------oM-------M-E---oo--o-----B-------------------------?M-------oo--M----Mo--------B---------o-o-----T-------M--M-o-M--
---B---B-oo-o-M-o---M-----B----o-?o---o----M----M-----?----o--o---------Bo-?o-Bo----oo---E--o---?-oo------M------?--o--------------B---o------B---o-o--M---o---B----o--B------o---E-------B?-oo-------B-
---o--E----?----M------o-?---------B-B-Boo--o----?------B-?-M----o--o---o--o---o--M?o-?--B--o-B?----B------?-B?-?-o-----B--?oB?--X-oo-?---------Too-M----BoB---oE?-------E-X?--oM-----B-?oo-?o--?B-M----
------------B--T--?oo-?o--o?--MM------o-BB----?------?--------------------------o--------o?------B------B-------o-M-----o-----o----B-?------oE?o----o--------E--B-----MB-B--o----------------B----------
----Mo--M-----------o--o?-------BT---------------M-?--o-B-?---------?-----M--o---MM---Bo----?X---o?----M-o--M--M----o---?oBoE--?------?-o-o-BM------Mo-B---M-----B-M-?--------BM----oM-M-?ME------oB--?v
---o---T-----M----B-------Bo------?-B-----B----?-------Mo--oBM-----------o--o------------oo-------------oM---------------M-o--Bo-?----o----------oMo-B----------oo?---MMo-----------M--o---B-B--o-?----f
--------M----------------o--E---------------oM--o-o---?--o-----B-o-------?--M---E-BM-B----?----o----M--o----M--o-o--E?---o?-----M------------MB--Moo-o-B-----------------E----------------o--o-o--o-B--f
---B-?---o-M--o-?--?o--B----?-oB-B-o-------?--------?---M----B---M--??--------B-M---M------E---------------------M--------o-------------M--o-o----o-M---Mo-------oMB--------?-o?B--Bo--?-?-----------o-f
-?---oM-------oM-M---M------oM--M-----oB--------B----o------B-M---------?-------------M--o???----?-o-?-?-B?B--------B-T-o-o----T--Mo-o--o--M?B---------?------o--o-------M----?-o-o-----o-o--??oBo-----f
-oo?------------Mo-o-----M--o----------oBoo---------?--?--------o--E----oB-B-E-oo-------MB-----M---o----M----B-?M-B--------------?oM-oM-----o-------?-----?---B-B-------M----------------------B-------f
-------------------------------------o--o----o-------o-o-------E----------------o-------------o----o--o-o----o----------------E--o---o-------o--o-o----------oo-------------------E--------T-----------f
m----X-------EM-E------To---oE------o-E-?-ToTT--X--o--E--------X-----o-----o--T--ooo-o---o--o---o------B--------------T--o-?-EM-T-E-o--EEX-X-oE---?T---EE-X---oo---T--oo--o---o?EE------oXX|Eo-------o-X
XX--XXXXX-XXXXXX-XXX--XXXXXXXXXXXX-XXXXXXXXXXXXXXXXXXXXXXXXXXXX-XXXXXXXXXXXXXXXX-XXXXXX-XXXXXXXXXXX-XXXXXXXXXXXXXXXXXXXXXXXXXXXXXXXXXXXXXXXXXXXXXXXXXXXXXXXXXXXXXXXXXXXXXXXXXXXXXXXXXXXXXX-XXXXXXXXXXXXX
