--------------------------------------------------------------------------------------------------------------------------------------------------------------------------------------------------------
--------------------------------------------------------------------------------------------------------------------------------------------------------------------------------------------------------
--------------------------------------------------------------------------------------------------------------------------------------------------------------------------------------------------------
-?-------B----?---E----------?B-o---------B---?-------B-------o--------??B-?-----o---------M-??--M-B-----B-?------B---------oB----B---o--E-E-o----------?----?---?--?-------------M-----M-----------B---
---------------o---?-----oo-?--oM---B?--o---o---E--o?---o-o---------------B----?------------M--o----?-----?---B----B------B---------B--o-B-?----------------M---o-------?-M?o-o---o---o---------?-------
--B--------B-M?----------?-----M-?------M---M--MB-?------------?-?M----?B----B-----------?oM--B-----------------o-----M-------o---------?o---B-?---B--M----?---------o--------M-------E----M--------?---
----B-M----------------oo-------M------M-----------M----M-------?----M---------------Boo--o------?---oBB-M-o--??----B-----B---?-------?----M---o--M--M----o-------M--?------?---B-------B---o---?-------
-Mo---o--o-?--B-----------?-----------M-----M-----------------------B-------------?o-----?----o---oM------------B---------o----o--?------------------o-----?-M----------o--B------------o-o-----------Bv
----o??--B-----?-o?---------------------?-M-------M------M-?---M-----B----B-o-------------B-----------o----M----o-o-M---M------------B--o-B-B-----------------------B----?o--?M-M-M----------B--M---?--f
---M?--B-o---?-------oM?----M?-----------------o-------------B--------------B------B----?------o-?-----------?-?---?-----B---M----------------o----------o------o-B---M---?---o?---?--------?-?------B-f
-B----B---oo-------------------o-----?--o-------?--------o?-----o--?---M--B?------Bo---M-----------o------oo------B-B---B-B-----------B--?-------o--B----?--------o----??--o-o-oB?-----------o---?-----f
-o----------o---M---------B-B-------------?-------------------o---------o-----BM-B-o---------?----------M---?-----o--M-----M---------o-B-----?-o-------?-----?--M-?----------------------?-o?--?Bo-----f
-------BM-----M--M-M----M-----BB-B--------------?-----B-M-o--oB-B-Bo------------------?----M-----?B?----o-----M----??-oM-?----------M-----M-------o--M-----M--?---o---B--o---M---?-B-B?---?---?----o?--f
----o------------------------------------o--o-----------o------o---------------------------------------------o-------------o---------------o-----------o----------------------------o-------o----------f
mo--E---------------------E----------------------------o-----------------o------------------o--------o--------------o------------o----X---o-----o--E-----o----------------------o----------------------X
XXXXXXXXXXXXXXXXXXXXXXXXXXXXXXXXXXXXXXXXXXXXXXXXXXXXXXXXXXXXXXXXX-XXXXXXXXXXX-XXXXXX-X-XXXXXXXXXXXXXXXXXXXXXXXXXX-XX-XX-XXXXXXXX-XXXXXXXXXXXXXXXXX-XXXX-XX-XXXXXXXXXXXXXXXXXXXXXXX--XXXXXXXXXX-XXXXXXXXX
