--------------------------------------------------------------------------------------------------------------------------------------------------------------------------------------------------------
--------------------------------------------------------------------------------------------------------------------------------------------------------------------------------------------------------
--------------------------------------------------------------------------------------------------------------------------------------------------------------------------------------------------------
--o?-----o---------?-M--------------?-------o-------M-------?---o------o-?-------M---o--M---------?------------------M?--------??M--E---------o-----------?-o--?-------oM----o?--------BM-------o-------
----M------o--E---?o-------?---B----------?-------------M-------?-M-M--?-------o----E------?o----B--------?----------o--?-o-?------o?-?----o------------?-----?---o-----o--?---------Bo-o---?---B-------
---B-------o?-M--------------M-o-B--o--M----?------?-B-o-?-------?---M-----oo---B-B-?--B-M----o----------?------o?-M------?-o-----?-------o--?o----------o-o---?-?---M---Mo-BM------------------o-------
---o---?---?---?Mo--B----------M?-M-----o-?-o---B-------E--o----------o---?--M-?---o-M?----o---B?-------M---?------o--?--o-----E-------o---o--M--M--------?-----E---?---X-------o--?----?--o---M?-------
--B?----??--?-?-----------?------o-----------------M----?---------------------?--------X-?-B-M--oMMo-B----M--------?-------?---M-o-?----------o--------?--------B---------o--o?-------------?----------v
-----o---o-----?M------M-------??o-?------------------------MM--?---------M--?-B----M---------------M--------o----o--M-?-------------??-------------?-B-----B----------???---o-o-----------------?M----f
----B?o-M-?M---o------------?-M--?----?-BM---??M-o----M-----------------o----------------------M--------o----------M------------?-?-o-oMBB---M----------?--------B--------?----BM-------o-o--o?--------f
---Moo---M----?----oo----o-o--oB----?-----M?-----o-------BM-??---------MM-M-?------o-----?---B?----o-------o------?-----o--o-M------M-------?o------------o-----o---?-------o--o----M-B--?-----B--B----f
--M---------B------oo----EE---o------B-?----M-?-------M-------?----?----------B?--o-MB-----------B-----B--M-----------?o----------M------------?-?--------------?----M-----?------?------------------M-f
-Mo---B?-----?----?------MBo-B?B-?----B------o-?--?-----?-------?Bo-----M--?----B-??------B-------------o--?-----?-------------------??--------o-o-Bo??-----M---------------------------??---B--M---?o-f
-------o-------o------------------------------------------------------------------------------------------o----------o----o-o----o----------------------------------------------------------------oo---f
m-----E--------------------o------o-------o---------------------Eo-----o-X------------------------------------E------E-------X-----o--------o---E---------------------o----------------------------X---X
XXXXXXXXXXXXXXXXXXXXXXXXXXXXXXXXXXXXXXXXXXXXXXXXXXXXXXXXXXXXXXXXXXXXXXXXXXXXXXXXXXXXXXXXXXXXXXXXXXXXXXXXXXXXXXXXXXXXXXXXXXXXXXXXXXXXXXXXXXXXXXXXXXXXXXXXXXXXXXXXXXXXXXXXXXXXXXXXXXXXXXXXXXXXXXXXXXXXXXXX
