--------------------------------------------------------------------------------------------------------------------------------------------------------------------------------------------------------
--------------------------------------------------------------------------------------------------------------------------------------------------------------------------------------------------------
--------------------------------------------------------------------------------------------------------------------------------------------------------------------------------------------------------
----------------------?-------o?o----?--------?----M---------------M?-?---B----?-------o---o-------?----o-?-----------------?---o---o-?-?---o-B--?-?-------?-----Bo--M-B--o---M-?M----------------------
------M-----o---?o-----?------B----M-----BM----M----------??------------?----?----?----------?-------?---?--E-??---B------?B---o---------M?-?B-B?---M-?-----------B-----M---?--?----o--Mo-----------M---
-??-oMo-----B-----o-----?---?--?--B-?B---o-o--B---oo-Mo?-?o-------??------?--------EMB----?---------Bo------B---M----BM--?---M-------------?------MM--------?----o----?--oMB--?---??------B-M----?Bo-o--
-o----?--B------?---------------B---o--M-------Bo-------?----MM------?-----?----?M-B-----M---B-?--o---------------------------o--------?--------?M--?-oM?-M?--o?----o------o-----------------?--?----M--
-----------MB-------?--o----?------Bo?-----------------o---------M-M?--------o-?--M---o-B-o----o--o------M-?--B-----?--M--M--o--------------?------------------------B-----------------M-----o---------v
---o------o-o----B-----o-------E----M--B----B-?o-----B----??----B----M----?-M-?-----?---------o-B--?--B-----o-----------?---?--?----M----?-M---X----?------B-o----M----M----------o---------M--M??-----f
--B-------M-------oB-M-----B---M---?------B-----------?--?----B------------M----M----M----o------B-------------M---?-M---BoMo-----?-------M-M----o--------o-----------?o------?B--B-----B------o-------f
-----------------?------o-?---B--------MB--B---B--M---o----M--oo??-M----------?-------E-o----------M---------?o-?-----B-----?---o---o---MB---------------B---o--M-?-M------------o-------?--B?o---o--M-f
---?-------?-?--------------o-------B?---o----M--?-M-Bo-E--------------------------?--?-M---?---------M-o---B------------------------?----M--?M-?----?------M----B------M--o--?oB--B-------B------o----f
--------------------------------------o---B-------?----?--?-------------?-----Bo--?-------o----------B--oB-M---o-------------------Bo------?-----M-----------B--o-?----------?-?-----------o---M-------f
---------------------------------------------------------E-o----oo-------------------------------------------------------------------E---------------------------------------------------------------o-f
m----------------------o--o--------o---------E---------o--o-----------------------E----------------------------------E----E---X-----o------------------o----------o-------E----o------o-------oo----X--X
XXXXXXXXXXXXXXXXXXXXXXXXXXXXXXXXXXXXXXXXXXXXXXXXXXXXXXXXXXXXXXXXXXXXXXXXXXXXXXXXXXXXXXXXXXXXXXXXXXXXXXXXXXXXXXXXXXXXXXXXXXXXXXXXXXXXXXXXXXXXXXXXXXXXXXXXXXXXXXXXXXXXXXXXXXXXXXXXXXXXXXXXXXXXXXXXXXXXXXXX
