--------------------------------------------------------------------------------------------------------------------------------------------------------------------------------------------------------
--------------------------------------------------------------------------------------------------------------------------------------------------------------------------------------------------------
--------------------------------------------------------------------------------------------------------------------------------------------------------------------------------------------------------
---------M---------o---B-o----o-?o---o----------?------X------------?--M----------oM--M-----o---M---?-B--?-----?--o---------------?o----?-------?---ooMo----?--?-----?----oo------------M----B??M-o-----
----M---------Bo-----B---------B------o--?-M--------------------?E-----------o--??-------------?-M--------------o----M-M--?-B--o------oM---o--o--?-------------o----------B??-------?-----?M--o------o--
---B--?---o-----M?B--------o------M-?--B--M-M-----?----o?--?------B-M--E---o--M?--------------?-M------M-B------?-------??-o------M-----M-----------?-?--?--o-M----------------?M--?---o----o-------M---
-----------B--M-----o-?-?------?-?----?------?------Moo-------B--?-----?B-B----------?---o---------?------o--------Mo--?----B------o--?----E---?-o---------???--B?-oo-----MM-?-----------M---o-------o--
---B?B-------?-----------?-----------?-?------?------------?---B---------?------------o--o-----B-?M------M-------B--B-?oo-?B---M-M---M--BB-B----------o--------o---?M--?-------?o--M---o--M----M?------v
-------?-------o-B---?----?----B------M-----M--M--?---?----------------B------------oo-?B--B-------?------M----------------------------------------?-------o--o----o----?M--?E----o---M--?o-----o-M----f
---o----o----------?------o---?--------M---------?--B----M--M?----------o?MB-?------?--------------------------------------?--MM--B---------o---o--o--------B-o--------------?MM-MM----?---?---E-------f
-M---o--?----M------------o-----------o--?-M--------oo--M---o---------?--------M-----?------------M--------------------------------------------------B-M--------B------B------------?o----B----BB-??---f
---B--M--------M---?----?---B-----------------------E-?o--------------------B----o----?-M------------o-------B--------B??----?-M-----Bo----o?--?M------------B----oB-------o-M?----?--o-?--------------f
--------M-------------?----------?---?-B--?---------B--??----?-o-----------B--------o---------------o-MMM-M-----?---------?--o-------------------o-----B-?--------M-M-o-----?o-----------?----Bo-M-?o?-f
------o----------------o-------------o--------------o------------oo----------o-o-----o-------------------------------------o-------------------------------------------E------o------------------------f
m----------------X--E-----o--o--------------------------------------o-------------------------o-----------------------o-------------o--------X---o--------------o-------------o------------o------E----X
XXXXXXXXXXXXXXXXXXXXXXXXXXXXXXXXXXXXXXXXXXXXXXXXXXXXXXXXXXXXXXXXXXXXXXXXXXXXXXXXXXXXXXXXXXXXXXXXXXXXXXXXXXXXXXXXXXXXXXXXXXXXXXXXXXXXXXXXXXXXXXXXXXXXXXXXXXXXXXXXXXXXXXXXXXXXXXXXXXXXXXXXXXXXXXXXXXXXXXXX
