--------------------------------------------------------------------------------------------------------------------------------------------------------------------------------------------------------
--------------------------------------------------------------------------------------------------------------------------------------------------------------------------------------------------------
--------------------------------------------------------------------------------------------------------------------------------------------------------------------------------------------------------
-----o------M---M---M?---?---o----??-------oo----------?-------?----o----------------M---------------B---?-------B---M-----------?-----------?-------------------------------------?--B--B--------M-----
--BBo----o---M----M---o-----------------------------B----------o-------M-----------------o--------M----o--------o--------------o-----B----?B-----------o-M---?------?----o-----B--Bo-M---------B---o----
-o--?---o---B-o---------B--------?B-------------------------MB--?--M--M---B--BB-----B--M------B------------M----------M---?---M?---M--?-M----M----------?---------?----o----o----------?-----M---E------
---?o-Bo-o----------MB-------MM-----B-----??----o--------------------------------M--------M-----------------B---?--------------ooB-------?----M-----o-------B--------------------BBM?-------B----?------
--------?---??-?M-B--------M----------------o-?----M-o-----------o---------------------?---M-M--o----M---------B-BM---------B-B------------?o--------------------------------?o?--o-------?-------?o---v
--B-----o----o-----M-----B---MB-----------o--E--M-?-?----?----Bo--?-----oB-------?-MBo-----------------B---??-------------M------o-B-----M----?-o---------?-------o-M----o?----o?------E------------M--f
-o---B-----B--B-?----o--M-M?------M----?----------o--?----B----------------Bo-----------?----o--M-------M-----M-?M---------?-----o----B------B--B--o---?--------------------?-------B--?----o-----M----f
--------B--------B--------o-o-o---o------M-----------o-o----M----B-M---o-?--?-------B----------o---o------X--o---o----------?o-------?-----M--M----M-------o--o-----------B-------o------B-----?-------f
------------------------------o-------BB-----------B?---M----?----?-----------------o----------------B--------?-----------?o------B-----o----B-M-----?-------------?---------?--?-----------------B----f
-------?M----M-----?---o----o--o--------?--?---------M--------------M-M---o-----M--------o----------B----?--------------o------B----M-----?------------?-------?-oo----Bo----------------o----B---o-B--f
------------------------oo-------------o-----------------o---------oo----------o-------------------------------------------------------------o---------------------------------o----------------o--X---f
m-----------o------o-----E----o------------------------------o-----X----X---X--------X----------o---------o------------o-X--------o-E--------E---o---------o---o---------------------T---------To------X
XXXXXXXXXX-XXXXXX-XXXXX-XXXXXXXXX-XXXXXXX-XXXXXXXXXXXXXXXXXXXXXXXXXXXXXXXXXXXXXXXXXXXXXXXXXXXX-XXXX-XXXXXXXXXXXXXXXXXXXXXXXXXXXX--XXXX-XXXXXXXXXXXXXXXXXXXXXXXXXXXXXXXXXXXXXXXXX-XXXXXXXXXXXX-XX-XXXXXXX
