--------------------------------------------------------------------------------------------------------------------------------------------------------------------------------------------------------
--------------------------------------------------------------------------------------------------------------------------------------------------------------------------------------------------------
--------------------------------------------------------------------------------------------------------------------------------------------------------------------------------------------------------
--B-M-----?o--?-B------?o--oB--Mo----M-B-oo---M---?-EM----M-?-oB-----o--------o---??---o-?----Bo-B-----?---B-o-?-o----oM-----ooMo--B------?----o-T-----M---M------o-o-BMB-o---oo?--?E------ooX-----?-o--
--o--Bo--o--?--M-----E-------o--------?----M--oM--o----o------M-------B------oB-------o---o---o--o-------oM---?oo---?E-----?------M-?-E---o---B---M--oo-M-B-B--B-o----oo------?--o-----M--M-----Bo--o-?-
---B?-?----?--o----BM-?o---oMo-M--M?--ooo?---M-------o-MM-M--B------o---------------oBM----o--M----B----o-o-o---EB---M--?---------oo-----BM----B-?-M---------o---?---M-----o---oB----?B--o--M--o----o-o-
-o--o----MB---o-BB-------M----Bo---o----o---------M?BoE-o-----?------M?M-------M-E-B--oB-o-o---Mo-oo--BM------oo?--?--o--?M--?-T-E?-?o-----?o--o--o----?o---o-B--------B--o--MM---------B------ooo--B---
--o-?oM-----?-MB-------o--o----?--B---------ME--?--o-BB-M?M----?o-----o----?--o-oT------B-----------------?--o?-o---M-o-o-----M--B-------M------o-o--B-o--??-----BE-ooEo---B-----M---oo----o--M-BB-M---v
-?---B-M-E----o-o----------?-o-o-o-B--oo--------o?---o----oo----B---?o-?---o---------------------M-----Bo--o-B-o------oo--o-----M---------?---B-------?------Mo-----Bo---E-o--?-Bo-oo------------oB----f
---------BB-----B-B-M-------B?Mo---o---------?-MM--ooB-----?--MB-M-------B--B-BB--M-ooB-BB-----MB--M------BM------o-oB-------B-----M?----M---M------ME---o-oo-o--------ooM---MoE-----B-o--B---o--?----of
------o?---M-----?--o--------o--------o----o----o------Eo----M----?MoBMo-o-Mo--------o-oooo-o-----o--M--o---?-o?---M--o--------B-B----?o--B-M--M-?B?oM?-?B-BoEM-B-----B----o---Mo--oo----B---B-M-o-BM--f
-----E--o-M-------oMoo-?--M---M?-----------Bo----------B-B-----B--ooE-o-B-----M--BoB--M------M---M-----Bo---oo---?--M-M---MoM--o---o--o-----o??--o--------BoEB--oM---B--------M------oo--oM---oo------Mf
---------E-B----o--oo-B---o-------o--B--o-Mo-M----oM---o---------oo-?M---------?-o------M------?o-B-?-o---B-----oo---o-----?----------?o-oB--o-o----o---M--o------oo-o--B-?---o--MBM--M---o-----MM--?--f
---o-o----------------------------o------o---o--o--o-o--------o-------------o--o-----E--o----------------------o------------o---------------o---o----o--o----------o----o-o------o----o-----E----------f
m-E-T--E---oT----ME---B-oE-oo--E----o-o-X---o-----Bo--T--o-E--o------------X----oXXo----E-Xoo-----oo-?--o----X---------o---X--o-XToo-----E-o-EE-?XT----T----oo----oTo-----o--EE-o--------------E--E-X-TX
XXXXXXXXXXXX-XXXXXXXXXXXXXXXXXXXX-XXXXXXXXXXXXXXXXXXX-X-XXXX-X-XXXXXXX-XXXXXXXXXXX-X-XXXXXXXXXXXXXXXXXX-XXXXXXXXXXXXXXXXXXXXXXXXXXXXXXXX--XXXXXXXXXXXXXXXXXXXXXXXXXXXXXXXXXXXXXXXXXXXXXXX-XXXXX-XXX-XXXX
