--------------------------------------------------------------------------------------------------------------------------------------------------------------------------------------------------------
--------------------------------------------------------------------------------------------------------------------------------------------------------------------------------------------------------
--------------------------------------------------------------------------------------------------------------------------------------------------------------------------------------------------------
----------M---o----------?--------o----------M----------------------------------M----?MoM---?---------M--------B-------------o-------------------o--------o---BM----o-------M------------B------B-------
---??--o---??-M--------M--------------MBo--M----?M-o-------------B-?-------?-B-----------------------M-------B--o------M--------------B------B---------M-----------BM-----------o---o------o--B-----MB--
-----o--B-------?o-------M---B--------o----------o--BBB------?-----------B--?---?E--M---?------o-M--------------------------B------------------?-M--------??-B-------M-----B---------------------?-?----
-----?----??-----M?---B---------M-------B---------Mo---M-------?----?--------M---?-B-----?-?--B---o-----M------------o-----o-B-o----B-----------------o---------MM--M-----o-----B--?--M---o--E-MB---B?--
----B---M----M---------------------?M--------o-?---------B--oo---??--o-B---M---o--?---M-----M----------B-M------B-----------?---M---o?----B-----?-----o----??---o-o-----o----o----?-o--------M---------v
------B-------o----?-------------?--o------M-------------------?---------B----?-------ooM--o------------M-?-----o--M-----M-B--------o-?-----?--------B---oB------o--o-oB-----------?-----------------B-f
-M----o----o?-----B----oo-M-------M------------B----B---o-BB--------o-----------M--M------------B-----------------B-----------MB--?-----MB---------------------?--o-?------------B------------M-M----o-f
---M-M----?-----o---B-M---o-?-----------B-------B----o-------------oM---?-?------o------------?----?o---------B-?---?---------------------------M-?-------B----o-M-----o-----M--------B-----B--------?-f
--B--------B--------o------------o----o--M--------------M---B-o------o---Bo-------M-?o--B------o----B----M-?o----------B----B----------------o-?----M-------?----o---B--B------o--B-----?--------------f
----------B-B---Bo----------------B---------B-------o----?-----------------------M--------?-B-o--------------M-B-------o----o-M---B---------BB-----------M?--M---------o-o----B-------M-o--------B-----f
-------------------o-----------------o----------------------------------------E--o-------------o-------------oo--------o----o-o-------------------o----o-----------------------------o---------------o-f
m-----------------------------------------X-oX--------------X---------------------------------------------o-------------------------------X-------------------------------o-------------------X-----X--X
XXXXXXXXXXXXXXX-XX-XXXXXXXXXXXXXXXXXXXXXXXXXXXXXXXXX-XXXXX-XXX-XXXXXXXXXXX-XXXXXXX-XXXXXXX-XXXXXXXXXXX-XXXXXXXXXXXXX-XXXXXXXX-XXX-XX-XXXXXXX-XXXXXXXXXXXXXXXXXX-XXXXXXXXXXXXXXXXXXXXXXXXXXXXXXXXX-XX--XX
