--------------------------------------------------------------------------------------------------------------------------------------------------------------------------------------------------------
--------------------------------------------------------------------------------------------------------------------------------------------------------------------------------------------------------
--------------------------------------------------------------------------------------------------------------------------------------------------------------------------------------------------------
-B??-M--------??---B--M-o--oo-?-----------??B---B?----B-----M?---o----B?----o-----EMo----o---o-?-------oo---o-------?------o--------M--------?--------M--o-----B-?-E--??---?--o---------?B?-------------
---o--------M-oo-----M---------B--------?--------------?-B---o---B----------?B--?-?------M?---?-----oo--o--??----?-------?---??----M---?o---o----MB-BB--o---M------B------B------?-?--------------------
-----?--?--?-----B?---?M-??B-B--BB-?------o-----B---------M---MB-----B-?------o--M---------------?-----?o---o--?---M--E----?-----?-----------?-----o--M------?E?--o------?-B---?---o-?------o----Bo-BB--
--B----M-?-----o----o--------o--o-M-B------------Mo--M---o--------o-----?B----?-B----B---o-----M----o---oB-Bo---------M-?------?----------?------------?------B-B--?------------B--M?-o----?---M---?----
-----------o-----?---o-Bo--?-----o------------M--o?----?-M----?---------------------?--B-----M-o----------B---o--------o---Mo---?----?--B--------B-M----B?--?-----------B------------M--B---B-B-?-B----v
---o----------?-----------B--M-------M-?---------------o----M----M--M?M-------M?-----------B-o--------------------oo---M--?-?---------M---o-----o--o----------B-?----??-------?--o-------M---?---o--M--f
---------B---B-?----------o--o---?--------------MM----------------oB---------Bo-?-E?--B-o------?---o--?---o----B-?--B----?-o-----B----------M--?---o--?--B-?B-----o-o---M-M--------------------?-o-Moo-f
-----?-?---o----M---M-?--o----E-B---------B----------o---?------B-------o---B--o--?o-----M--o--o----------o-----M--M--B----?---o--M--------?--o---?----M--B-------oB------o--o-------o--?--------------f
--E?---------------------?----M-------o-?-----oB-?---o------Mo------E---B-o--o--------B-B---o?----B----------------------Bo--------o-?-?-?--o------o-----------------?o------------B-------------?-----f
--?--o------------o-------?--------B------?-?------BM----o-----B--o-?------------MM-?------?----------o----?---B-M---?-?--B---------M-------------?-----MB---?---M-----BMo?-o---oM-------?---M?-o----M-f
-------o--------------o-------X-----------o-----------------o----------------E-----------------o----o------o---------------o--o--o-------------------o--o-----------------------------------o-----X----f
m------E--o----XX-----o--X----X----X----X--------X-----------------------o------------------o-----E----------o--X--------E--o----------------------------------o--------o------------------E------X----X
XXXXXXXXXXXXXXXXXXXXXXXXXXXXXXXXXXXXXXXXXXXXXXXXXXXXXXXXXXXXXXXXXXXXXXXXXXXXXXXXXXXXXXXXXXXXXXXXXXXXXXXXXXXXXXXXXXXXXXXXXXXXXXXXXXXXXXXXXXXXXXXXXXXXXXXXXXXXXXXXXXXXXXXXXXXXXXXXXXXXXXXXXXXXXXXXXXXXXXXX
