--------------------------------------------------------------------------------------------------------------------------------------------------------------------------------------------------------
--------------------------------------------------------------------------------------------------------------------------------------------------------------------------------------------------------
--------------------------------------------------------------------------------------------------------------------------------------------------------------------------------------------------------
-------------E---B-B-o----?-------M------?-Bo----o-----?--?-?o---?---?--------M-Bo--?----?-Eo-o--o----Mo-----oM--o?o--M---B---M-------o-ooo------E-o-?--B?---o-M----B--?---B--o--B---B----------B----M--
-------------B-o---o---------M-M---o--?----ooB-o?o------B?--------o-----B-B---ooo-?-----o---M?-o-M-o-o------------o---o-?-----oo-o--M-o-MM--o--o--o---------?o-o--?-------o---------------B--M----o--o--
---MM----?-o------------?--B-oooB?--B---o---------B?-----------o-ooo--M---o-?--oM-------------B-oo------?----M----o---M----oo?--oo?M------?---?------o-o---ooo---BoBo---oM---M-----?-o-?-?------o-o-E---
---o--------?-o--M-oE--M--B----M-----oo--M----?--------B----B-B--BB----o---?-oE---o--B--E---??-?------Bo--B------B-----o---o----oo-o-?o-oM-?---Bo?oM?---B----B-----o------------?-B------o-o----M--B----
-M-E--B---B-ooE-B-?o-o-----M?--oB-B?M--??oBBo---Moo---M-BB-BoooM--o--B---o--o-----M-o-?-------E--o----o-oM---M----oo-M---BME-?oo----?-o-----------o------o-oB---o---BoM?----o-B-----?oBM-----o---------v
--oM-B------oo-M---------B--------o-----o-o---?---M--o-oo-----B-B--?oo--B--o--?--B-----E----o-M--?-----M---o-----o---------Bo-E---o-o----?o--------------o-----M-??Bo-------?-----MM-?--------?-?---ooEf
---------------o---------o---?o-M--o-----------?-?--Mo?----M--------Boo--o-E?o---o--------------ooo--M--BB--?----?----------B-------M-o-----o----M-?--BM---?-------o-M-------?-o---o-------------------f
-??-M---o---B-o---------o-----o---------ooo-------------oM---Bo-?-MB-Bo-M-o--------oo---------B---o-?o-----M--?B-------M-oBo-M--Bo?-o--o-T-B---?----o--o--B----?--o-------------o--oBB--oB--M----?---BBf
-----o-o---------o--B----o-----Mo-?---Bo-B-?-o-?---M?-o-----?-------------------B-B---?-o---------o?-o-Moo-o----oM-----oo-oo---Mo-------M---B-?-E-E---------?-E---o--------M------oo--o?-ooo--------B--f
-oo------------MMM?--o-M-B-----o----------B-?o--------M--------------------M-o-oo---M----M----------BM-o--T--o-o-o-B-o?---M--M-oo----?B---?B----BoMMM----B----Bo-o?-oBo?B----------?-----M----M----?---f
---------o----------oo------------o--o---------------o--o--o--------------oo---E--o--------o--------------------------o--o------------o---------o-o--o--T---o-----oo----o------------------------To----f
m--o-X--o----E---oo--o-o----o--XX---o--------X-EE-----T--T----oE---X-E--T----E----------E---E-EEE--oX-T-E---XEX-o--XEo--o---Eo-o-?--?-oX--------T-------|-----------T---T-----XE----o-o--E-------X-----X
XXXXXXXXXXXXXXXXXXXXXXXXXXXXXXXXXXXXXXXX-XXXXXXXXXXXXXXXXXXXXXXXXX-XXXXXXXXXXXXXXX-XXXXXX-XXXXXX-XXXXXXXXXXXXXXXXXXXXXXXXXXXXXXXXXXXXXXXXX-XXXXXXXXXXXXXXXXXXXXXXXX-XXX-XXXXXXXXXXXXXX-XXX-XXXXXXXXXXXXX
