--------------------------------------------------------------------------------------------------------------------------------------------------------------------------------------------------------
--------------------------------------------------------------------------------------------------------------------------------------------------------------------------------------------------------
--------------------------------------------------------------------------------------------------------------------------------------------------------------------------------------------------------
----------??---------------M-M--M--M---------?o--------B---------o-------B-M---?--?o--o-o-------B----?------B---?-o-?------o---B-----M----M----------------o-------------------?----B---------B---------
-??--------o--?----B------M-?-----?-------oB-----?--------M-----B-----B-?------------------B-M---o--------o-------?--?----oM--------o-E-------M-----o---------M-o--?--oooo-o----B------Bo---------------
--------?o?----------o--?-o-o---M---ME?----o--B?--MB----M----------B-B-------o-------??-B-----------?---B---------o----B-----o------?-?----------M--?------------B---?----B--?------?B------B------Bo---
--M------?---B-----------o---o----o--M---M-------------o-?B-----------------B----?o----B-------------------B--------oM--M-------------o----B-E-M-o---?----------------------B----M----?---M--E--?----?--
---------------------?--o-----o?-------M-------o--o-M---------------------B----oo-?--------?----------M------o-----------o---?----?---o?--?--B----M--------M------M----?o-B-----------------MB-Bo------v
------B-------------------------o-?o--?--MM--?----------------------MB-----B---B---o----------M-----M?o-M---?--?-------M--o----M-------o------------B---------------?M--------------M---?-B------------f
-M-?---o-------o--B---Bo-B-------o--------------o--Boo?-?-?o-----------?-?-------M-----oB----------------?-----------------------?---M--o----------o----------E--MX----B----M------------o--?--M-M-----f
--------B-------?-------BoBMB----------B--------------------B---?---------------M---------------o--M------------Mo-?----?--B-o------?------?-?------?----oo---M-B-----------o-----M-B------------------f
---------------?------o--?------B-?------------o--?------B---?-------M-o----B------o--------------Bo---------M----M----?----M---B---------o------o--o------------------?-o------------B--?---------?---f
----B-B-----B--o--------o-----M-----o--B----M------B-?-----o----?--B--------o-?---o--------------o-?--o---------M---------B------B---o-----B----o-----------o--------o----?--o-----------oo---------M--f
--------------o-----------------------oo-o--oo-------------o---------o---o----------------o------------------------------------------------------------------------------------------------------------f
m-----------E---------o---------o----------------X--o------------------o----------------o--o------------------o----X-o--------------------------E---o------X-X-------------------X------X----T---o-----X
XXXXXXXXX--XXXXXXXXXXXXXXXXXXXXXXXXXXXXXXXXXXXXXXXXXXXXXXXXXXXXXXXXXXXXX-XXXXXXXXXXXXXXXXXXXXXX-XXXXXXXXXXXXXX-XXXXXXXXXX-XXXXXX-XXX--XXXXXXXXXXXXXXXXXXXXXXXXXXXXXXXXXXXXXXXXXXXXXXXXXXXXXXXXXXXX-XXXXX
