--------------------------------------------------------------------------------------------------------------------------------------------------------------------------------------------------------
--------------------------------------------------------------------------------------------------------------------------------------------------------------------------------------------------------
--------------------------------------------------------------------------------------------------------------------------------------------------------------------------------------------------------
-o----B?M--B---------------------?MB--E---Mo-Mo---------X----M-o--BMo---o---oBo--B-?---o--M-----------?---?--ooBE--o--o---o-o------B--?---B-o-?-?----------M---B-------------?-----------B-Bo-?----o-M--
-?---B-----o?----o-oBo---B-------o--M-M--------o-M--?-E-------------M-M----oB---o--o---E-----------M------o-----MM---o?o--------BB--??---o--?-----M-----?-o-?----------?--o--------?-oo--------o?-------
-o-B----B-------?---------o-----?---------?---?------o---BMo-------Mo-----o---oo-----?-?-?o--o-oB?o-------?----o---M----B-?---oM--------o-B------ooT-----------?------?--oo-----?-----o----------BoTM-o-
-E----?-o----------?-B---o-o-ooMo----B-B----B-----M-?M-o-o----------?------To---?oMo------M-oB-B--E--o-------o--E----B-M--o--o-----BBM----o--?-EM-------o--?--B---------BM----B-----?----o-M-M-o--M-----
-M??-----B------?--o-o---B?---------ooo-B?-o---M---?-----------??-----------M--------------B-------oo-o----Mo----M-BTo-------o-oo---------o---M-----?-o?-------BB------o-----o--------MM--Bo-----?o---ov
---o--B-o-o-o--o--B?------oo-M--E---o--------B-------B----M--MM---BB-----o---B---oooM---oM---?----M--B----o-M-o-oo------o-----E-----o-B?-?M-BB---Mo----------------M-----------------M---M-oMo---oo-o--f
--M-M-----Mo-E-MB---------o------o-o---o---B-----?-M--B?-Eo----o-B--oM-B---M-o-------M?ooo---o---M--------------B---B----B----M---?o-------o--?--o-E---ooB?--o-BMB----o?M-o------o?-Moo----o----o-?o-?-f
-B--o-------o---o---oB--------M-B--o-T-Mo----------------BoM--M----------o------?-BM----------------B-B-o-oE-o----o----o----M------o-----??T-Mo---------o---M-----?--?o-o-?-o---o-----------M--o-------f
--o-oE----?MEEM-Eo-o?o?-----------B---B--M---------E---------M--o-------?o-o---M-M-------BB-----o-?----T--B?---?---o---?M----?-o--------?----o---B--B--o-o-----?---o--M----------M---o?---M--M------o-Mf
-----Mo--o---B--M------M----Xo-M--o-B--oMoM------o---------B---?o-MM--X------BB---o-?-?-?oo?B-----o-M----M--------------o-X----?-------o-o----X---o--oM-----M----?--?-o-o---o-MB---E-B-o---B----oo-----f
--o----------o---o-o-o------X-Eo--E--------o---------------o--o-------------------o---------o--------X-------------------------------o-o------------------------o---o-o--o----o-----o-o--o----o--------f
m--E--oXT--------X-?--o----oX-T------X-o------o--------X-------o-------o----E------E-----ETXT-----TT---------E--To--o---oo---------------Eo--XT-oo-o--o-o-----ET-ET---EEE----o-Eo----T-X-----o---XE--o-X
XXXXXXX-XXXXXXXXXXXXXXXXXXXXXXXXXXXXXXXXXXX-XXXXXXXXXXX-XXXXXX-XXXXXXXXXXXXXXXXXXXXXXXXXXX-XXXXXXXXX-XXXXXXXXXXXXXXXXXXXXXXXXXXXXXX-XXX-XXX-XXXXXXXXXXXXXXXXXXXXXXXXXXXXXXXX--XXXXXXXXXXXXXXXXXX-XXXXXXX
