--------------------------------------------------------------------------------------------------------------------------------------------------------------------------------------------------------
--------------------------------------------------------------------------------------------------------------------------------------------------------------------------------------------------------
--------------------------------------------------------------------------------------------------------------------------------------------------------------------------------------------------------
--?--Moo---B-??--oo-?------------MoB---------ME-------?-o---ME---------BM-?-----?o--?---------------Mo----B---o--o-o------o---?--M-----?-E-Eoo-o-B-o?B-?--------o-----o-?---Xoo----o?---ooo--M-M------o-
-o-----?---o?---------M----o--o---o-------M-o-----o----BoB---?-----o?-?--M----M--o-B--oMM---B---o------EB-------oB-o--?Mo--?o--o?o----M--B-?E-o-o-o?-----o-M--MME-o-M-M-----X-B-----------------o----M--
-----------M--B---B--o---?o--o--oM--?---M-oBoM--B-B--?E---?--o-BB----o-o-o--o?--Bo--o------M------o----------MB--oo------B---MBB--o-?-------ME-----------o--B---BB?B----o---------B-BM---o-o-----M--M---
-o--------M----B?---o-----E--M---------o----M---------M---oMM?---EM--------------o--E-o----o-B--M--M-M-------------M------------o-oo--BM--B--BE?-o--M--o----o?--o------XM-----M--M----B-Bo---B--o---oo--
------?---o-To----To---M-------M--o------?----EM--oM----oM-o-o-o-Boo---M---o?o?o-Xo--M--Bo--o-BBo-----B--?-M----BMo-Mo-----M-Mo------o----o-------oBo-o-o---ooB-o---M-B---E-M-----?--B---MB-------M---Bv
----??o--B---o---M-----------o-----?---E-o-oB-Bo?-----?----------oM------o----------M-?------B-o-B-o-------------o-------M--BoBM---o-B---o-----oBB-----o---oB----------?--MB-----BoMo---Moo--M-M--oM--of
-----o------BB---oM--M-----o--o--o----M---o-o----o-?M--?--B-o--B-M---BB----oo------o---?--o-o-----o---ME-B----M-----o-M-o----------?---o--?BM--------M--------o-o-o---o-M--oB?B-------B------o-------M-f
-B--B-M--?------oM-----?------M--?-------oB---oo?-B----o-------o----o-----B??--M-o------?--?B?--M-M----Mo-M-o-----oo---E-o-oM-----B-M--------?E-BM------o-----------E---o?o------?o---o-o--B-?------E--f
--o--?--o---M?-M--o-------o--o----o-?-o--------------------?M----?--MB-?-M----T----B-oM---o---o-o?o-o----?-----Mo-oo-ET-----o---B-o------M----B-o--?----o---o-------??-------?M---MMo----------??BM----f
-?--B-B------o--MB---M--B----?o-?-ooo--B-----oM---oB?--o--o-o--M-o-B--M----M---o--Mo-B-------?---o--B-oB--M--M-----o?M-M-----------M-MB-------o-B?B-----?o-------?B-----------o-B-----o---B---?----?B--f
-------E--oo----o-----o-o--------o-----------------------------------o-o-------o--o-o--------------------------------o-----------------o----T-------------o------o--------o---o-oo----o----o-T----o----f
mE---T--oo---------------o-o--o-E-E----Eo--T--T--X---o----o---o------o-------T---o--EE--o----o--o-----T-ooE--XX----oE----o----TT---X-----oE-X------o-XT-E---o-o------E--o---Eoo-----o--oT-oo-X-M--oE--XX
XXXXXXXXXXXXXXXXXXXXXXXXXXXXXXXXXXXXXXXXXXXXXXXXXXXXXXXXXXXXXXXXXXXXXXXXXXXXXXXXXXXXXXXXXXXXXXXXXXXXXXXXXXXXXXXXXXXXXXXXXXXXXXXXXXXXXXXXXXXXXXXXXXXXXXXXXXXXXXXXXXXXXXXXXXXXXXXXXXXXXXXXXXXXXXXXXXXXXXXX
