--------------------------------------------------------------------------------------------------------------------------------------------------------------------------------------------------------
--------------------------------------------------------------------------------------------------------------------------------------------------------------------------------------------------------
--------------------------------------------------------------------------------------------------------------------------------------------------------------------------------------------------------
-----?------M---Bo-o---M----o-----o--------------------M----------o---?----M--------?-----M--------B?--o------oo-----?--o?----------?---o---o?o----------o-------B--?B-M-------B-------------?----?-----
--BM---o-------?-Bo---------o?----------B------?---o--?--------?--?-------B-----M-B----------MB--------------B?---o--------o-o-------Bo-E-----o-o-----------?---------Bo-M------------?--M-M---------B--
-----?-----o------B---?-------o-M-BB---------B----B----------?--o----?-----?--M---o-------?------M?o-------?---------?----M-----o?-o----Mo?----oBBBo--o---------M------o?---o---B------?-----M----------
-o--?-------M---BM----------M--------o----o-------------B-?M-o--?B--o---M--------M-?-?---B-B--o-----?-B-B-----BB------o----B?-BE--M------------B-----------------B----?---------------------------------
---M------B--------M--B----------M?----------B-------------------o-o---Bo-----B----oB-----?-?---o----?o-----?---B--?--oo-----------B-------?----o--M----B---o-?-----?----o------M--------?-------------v
--B----M------B--------B----?---?----?----------M---B--o-----M----Mo-Mo--o---------M-B------o------o---M---?---------o--------BM--M--o-----------B-------??o-----------------------M-?o?-----?----MB---f
------------?-------B---------o-----------o--------B-----------o?M-----------o--M?B--o-B-----B-M--BM----?------M-------------?---------------------?----?-------?--M----------M-------------B--Mo------f
----B?B--BM---------------M--B----?-------?-oM?--?----?---?---o-------------o--------o---E--o----M--?-M--------------------B------M---o-B------o------------M-------B-----------------oo-oM---------?--f
-M-----M-----M-B?------B------MM-----B------------?----------B-o------?-B----?o--?-?o--B---B--oo--o?----B-------------?-B-B--B-----------------oB-B--B-B---oo-----oo------M-?----------BM--------------f
--M---?-?B----------o-B--?-?-o-oo--------BM--B?-M-------?--B------?---o-o------?--M-------------o-------o---B--M--------o-------?------?-------------------o-o---?--?o---------?-----M?-----BB----B?---f
--------------------------o-------------------------o------------------------------------------------------------------------------------------o--o----------o--------------------o---------o----------f
m--------E---------------Xo------oo-----o---o-o---------------------------X--o----o-X--------o----E-----------X-----------o-----------------X---o--o--o--------------------------------o---X-----------X
XXXXXXXXXXXX-XXX-XXXXXXXXXXXX-XXXXXXXXXXXXXXXXXXXXXXXXXXXXXXXXXXXXXXXXXXX-XXXXXXXXXXXXXXXXXXXXXXXXXXXXXXXXX-XXXXX-XXXXXXXXXXXXXXXXXXXXXXXXXXXXXXXXXXXXXX--XXXXXXXXXX-X-XXXXXX-XXXXXXXXXXXXXXXXXXXX-XXXXX
