--------------------------------------------------------------------------------------------------------------------------------------------------------------------------------------------------------
--------------------------------------------------------------------------------------------------------------------------------------------------------------------------------------------------------
--------------------------------------------------------------------------------------------------------------------------------------------------------------------------------------------------------
------o-B-Bo---------MB--o-?-B--B--o-?---------??-o--M---B----?------------------M----------B-------B-M--?o------B-----oM-------------------M--B-------B---?----oB-----?--E-----------------?-----------
-B?------o-----M--??-----MM----------oB-------------o------------?--B--?---M--?-----------B-----M--?--o---M------o-B-----B-------------------M--------------?------M------B-o------B--------------o-----
------oB--------?----o-------------------o----------o---B---------M-------?----------M--------------BB-B--o-?o?B----B----------M--o-----?-o-----B-----?---------B-o--o?-?------------B?B---?-?----------
----M-ooo----------o---------B----M----B-o-MB------?B-------B-------o-?B---M-?--o-?----M---o-oo--------------oo---o--B---o-o----------B-----o------------oo-------------o---------------B-------------M-
------------ooo-----o-M--o-----M-----??-o------B?---------o-------B--o-----oo------B-----B----------?------------------------------?--------o----M-o----o??---o----------?o?-?---B---M----o-B-----o-?--v
-----M------M-o---M----?--o---B-oM-Mo---o?-----o-----M----o-------------o----?-B--?--------Eo?-----M--B-----------o-o----B-o----B-?-------?-----M-o--?-??------o----o-M---M--------?--MB------?BB------f
-------------------o------------o-----o----o--------------M-o---------?----o---------------M------?-?-------B----------B------M---o---B-------?-----o------B--------M---M---o---M---------------------of
---?----------M-----B--Mo----B--o------B-------o---------?o-M--oB----?----M-o-o--------------M---M------------?----------o?-------M-----o?----o-?-----M-------------------M--o------B-?---------?------f
-M----?---?BoM-B--------?----------o--------------?----------B-M-------o-o--Bo--------------?---M------M?M--?--------o-----------B-----M--B--o---M-----oo-oM----------BoM--B-----?-o-----B---?---------f
-o---?--?----------o------------------?Bo-o----------B------M--------Bo---------Bo---B-------?-?-------------B---?--M--?MM-B-o-?---?--M---------o---------------B-----------M--o-o------B-M---??--B----f
-----o--------------------------------------------------oo------------------------------o-------------------o----o--o-------------------o-----o------o--o-------------------o-------------------------of
m---------------------X------o-----------------------------------------------------------o---------------------------Xo-----------X------------------------------o---o---------------------X-----------X
XXX--XXXXXXXXXXXXXXXXXXXX-XXXXXXXXXXXXX-XXXXXXXXXXXXXX-XXXXXXXXXXXXXX-XXXXXX-XXXXXXXXXXXXXXXXXXXXXXX-XXXXXXXXXXXXXXXXXXXXXXX-XXXXXXXXXXXXXXXXXXXXXXXXXXXXXXXXXXXXXXXXXX-XXXXXXXXX-XXX-XXXX--XX-XXXXXXXXX
