--------------------------------------------------------------------------------------------------------------------------------------------------------------------------------------------------------
--------------------------------------------------------------------------------------------------------------------------------------------------------------------------------------------------------
--------------------------------------------------------------------------------------------------------------------------------------------------------------------------------------------------------
-M-----------?---------?o?---M--?--BM-o--E--?o-----?o--------------M--?--?-o---B------?-?-o--?----M-o-------o-----------M---------o---o---------o--M-----------o----B--------?-------?--?-----B----M----
----------o-----?o--B------M-o-?-?o--E---B-------?------?M-----B-o--B-------------B-?--?-M?------------------o--M----------oB------o?------M-?--------M?--?--M--?-??---o?-M?-o-oM-----?---------?-------
-o----B--------?-?--o--M----o?------??---------------M----------?-------?--M----?-------?--------M--?----o-?-----?----?--o---------o---o------?-?B----------M-?oo---oo--------------M--------oo---------
----------MB----------------------------M----?---------o---o--E--o-----B----B-o--?-----M----B--o--?----B---oB--??------??----B-------Bo--B--------?--B---------?B--?-o-------?-----------?-?----M-B-----
-B----------??----?------?--------?-?-?---?---------------?---B-BM---B---------??-M?--M----o-o-----Bo------X-?-----------o-----------o-----------o-------------------?-B-M----BB------??-------?----M--v
----?M---B----------?--MM-----------------o-----o-E--M-------B----o-M----?---o----------o--------------?-?----?o--------o-Bo-o----?B-o--o-B-----o-------------?--B?-----------------o----o---o----?----f
----------??o?-----B-?------M-?B------------------M----M?----------------o------?--E----------B----?--?---?----?---o---oB---B-M-------------B--o--------o?-----oM---------?-------?----M-B----?----B---f
-----------------o-o--o------?---o-------?M-M-B--------------o-?-------?B---M-??---B------?----------?--M-------B-------------------M----------oM-E---M-B---??-----?------------o------o-------oM---o--f
-oo?---E-E--?-----?-----o--------o---?--M---------?------Mo-o?----o-B-?----------?--B--o?--------B-----------E?--?-??--?----------B---?--------M--?--B-?------------o-----------------?---?BB------Mo--f
----B?-?-B---------M-B------?--M?o-?---------oBM---?-MM?--oB---?-?-----?----?-?---o------?-o------------?---M?----?------BM---?------?-?-----?-o?-------o----o-----o----------------M---X?---o---?--B--f
-------o-----------o----------E----o--------------o---------------------------o--------------------------------o--------------------------------o-o--oo-------------------X-o-----o---E-X--------------f
m-------E---------o-----------X-----o-------X----------o------------------o------o---------E------o--------------o-----o-------------------X-X-E-------------E-----E------X-------------X--------------X
XXXXXXXXXXXXXXXXXXXXXXXXXXXXXXXXXXXXXXXXXXXXXXXXXXXXXXXXXXXXXXXXXXXXXXXXXXXXXXXXXXXXXXXXXXXXXXXXXXXXXXXXXXXXXXXXXXXXXXXXXXXXXXXXXXXXXXXXXXXXXXXXXXXXXXXXXXXXXXXXXXXXXXXXXXXXXXXXXXXXXXXXXXXXXXXXXXXXXXXX
