--------------------------------------------------------------------------------------------------------------------------------------------------------------------------------------------------------
--------------------------------------------------------------------------------------------------------------------------------------------------------------------------------------------------------
--------------------------------------------------------------------------------------------------------------------------------------------------------------------------------------------------------
------o--E-------T---M---o--M--?-o------o----------------o------?-T-------------------------B---o-------------?-----------------B---B------------?----o--------o--------------B----M--------------------
-----------B-B-B----------B----------B------------------M-----E-----------?-?-----------B-?------?E-------------B----------E---M-M-----?-----B--B---?---------?------B-------o----B-B?------------------
----------------------------------------------?------------------M---B--?----B-----o---?-?--X-----B--B--------?--M---------MB-----B-o----B-M--B------------------B---------E---B-----------------M--M-M-
------?----------??---------------------------o------------------------o--?-B--------------X--------------------?-----------------------------oo----TM--M--?B--------------X----------------------------
-----------?----------o----------------M--------------B-M--o-o-o-----?-------??----o?B-----------M--Bo-------?-------M-?------?o---?-----------o--------------M--E---------------T-B--------------E----v
-?-------o-----XT------?--o---?o---------------------------oo---Bo--E------------------------------?--------B------------?-----?----------B------o--------B------M--B---o------M----------B-------MM-M-f
---------?o-----------B----o----------------------------B---------B-M--------E----?--------?o----?---B-B-------------M----------------------M--M---------Mo-------------?--B----M-------M--------M-----f
-o--o-B-B------------------------------------o-------o----oT-----M-M---o-----M---------------o------M-------?---------------B-----?--M-------------?-------E-o-----------B-o------?------E-------------f
----o---------M--------------B-------------?-----------M?---B-----------------------o--------Mo---M?--M----------------------------o---?-------B---------------------B--Mo--o----------?--M----o--o-B-Mf
--o?--B------B------o----o----------------------M--??oM---------------------?-M---------B-----------------------M----M---------------------E-E------?------B----o----o------------o-?----M-------o-----f
---------------o-o---o---------------------------------------------------------------------------------o------------------o----------E--------------o--------o-o-------o----------------------E--------f
m--X------TX--------o------o-----------o-------X--------------o----------o---E---------------------------X------XXX--o----------T----------M--T--o-o------o----------------------o--------------o------X
XXXX--XXXXXXXXXXXXXXXXX-XXXXXXXXXXXXX-XXXXXXXXXXXXXXXXXXXXXXX-XXXX-XXXXXXXXXXXXXX-XXXXXXXXXXXXXXXXXXXXXXXXXXXXXXXXXXXXXXXXXXXXXXXXXXXXXX-XXXXXX-XXXXXXXX-XXXXXXXXXXXXXXXXXXXXXXXXXXXXXXXXXXXXXXXXX-XXXXX
