--------------------------------------------------------------------------------------------------------------------------------------------------------------------------------------------------------
--------------------------------------------------------------------------------------------------------------------------------------------------------------------------------------------------------
--------------------------------------------------------------------------------------------------------------------------------------------------------------------------------------------------------
--oE-M-?M---M---------oE---B--B--B??-o---oB----M---o-?-?-B--------o------B------o-M-E-?----------M----?o-----B-ooo-----B--oo---------?-MMo?-M-----M------o----o-----BoB-B--M---?-----?-o-?----T-------?-
------------o----------?--------------M--B---oBoo--M--oo-o-------B-?BE--?o-?-B-Bo--?--o?--?B--M-----------o----E-M------M--------E--------o--MB--M----o-Mo-MME--E-oo--oo---oMoB--------------E--oBoE-o--
--M?----BB-M-----------o---B---B-o------?-?B-B--oM-o-----?---M?---------o-?----o----?-B-o-o------?----o--?---o?B------?--M---o-MB?E-o------o--oB-------Bo-?---BB----M-----B-ooo-------BoBMMoo--TMo-B-o--
---o---o-----?---M--o---o--oMo----ME-----------B-----MooB------------B---B-M?----------?-o------B------------------EE-o---o?--oo--M-----M-o?B--oE--oo-M--o----o---o-oB--o------------M----o--BB-------M-
---MMo?--M-B-------M---?--o--o-M-o-?M----o--o---EM---o-o--M-?---------o-o--oo--BM---BM--?--M-o----B-Mo-o-o-B--B--EM----M-Mo-M------?---o-----------o---?-oM----?---M------MB----o-?------B?--o--E-o-Mo-v
-------?--M-----------o---M-B---o-M--M----o--?----B--o----o--o------B----o--?-o-o----o--o---X--Mo----o-----o-------?--------------o--oo-----------?-------o-------?o-o-----------o-E-o-??------o-o-----f
-?--M---------o?----oEM------B--MM--o-?--M--o--BM-o--o---------o--?----?----o---B-o-------?M-B-----?o--------?oo-M---EM------EB--E--M-----B--BM--o-o----oM--------o------B---BM----?-oB--E-----o---o---f
--M----T-oo---------??--?------Mo--o-M--T---------B---M-o-----?o-----B------M----B-?o-?o---o-o--X---?o---------M----BM---?--o-oo-B?M----B---?----?B--Bo-------?----MM--oE----o--oMBo----M-----M?--o----f
-B-?-o---M-----BB-----------M---M--o--M---B------B--E-----?---o--------o----o-?--o?--Mo--o----Mo-Bo-----B-------oo-To-------?---E-----B------o-o------o----?----------?-?o?---------o-----M--?o---?----f
-----M------------------???B--?o-?------------?---?BB?--------?--MM-TB?--------?M------M--o-------M--M-B-M-MB---E----MM-?Eo----M-------o-----TM----o---------MM-?--BB--M---M----------o-?B------ooo--o?f
-------o------o---E---o-----oo--o---E----------X--o-o-------------o--o-------T-o----T---------o-------o----o--------------o----o-o-------T---------oo---o-------o----oo-----o-o-----------------E---E--f
m-o------EE-TEoX--Too-oo-B-M--------T------o---X----To-?EE-oX-------E--------|-T--?----o---EE--oo---ooXo--------o-oo-E--o------o----oo---X---------oT-------X-----E-----------X-----oT----Eo----T--oX-XX
X-XXXXXXXXXXXXXXXXXXXXXXXXXXXXXXXXXXXXXX-XXXXXXXXXXXXX-XX-XXXXXXXX--XXXXXXXXXXXXXXXXXXXXXXXXXXXXXXXXXXXXXXXXXXXXXXX-XXXXXXXXXXXXXXXXXXXXXX-XXXXXXX-XXXXXXX-XXX-XXXXXXXXXXXXXX-XXXXXXXXXXXXXXXXXXXX-XXXXX
