--------------------------------------------------------------------------------------------------------------------------------------------------------------------------------------------------------
--------------------------------------------------------------------------------------------------------------------------------------------------------------------------------------------------------
--------------------------------------------------------------------------------------------------------------------------------------------------------------------------------------------------------
---E--?-oMM----------B---E-----M-----?-----Mo-----M---M--?--E---BB?o-o-M?o---EM---B---B-E-----B---o---o?--?----BMMM-----M-M--------?-o-o-M-?---oo--o-------X-?--E-?----------o--------o---M------?-M----
----?--------------M----??---M---B--------M--M?BM-o---------M------------B---M---?------M------------?-o--o---B------B-------o----------o----o?-o---Mo------o---B----M------------???--oBoo--?-----oM-o-
-B----?-----BE------B-B----oo--?ooB------?-o--o---MB----?----?-?------B---B-------------o?-o-M-?--oo------o------T-----o--MMB--?---?Bo-B---o-oo---------?--o---M-o-?-----B--B-MM-----B?-----oo--------E-
------o-o----B----o--M------o-------B--o----?o---------o--o------M-?----M----o?-----?-?B?----o-----?o--------o-----------M----?--M----?o-o--o-----M--B-Bo?MB---o--M-o------o-------oo--------oMEo-----?-
-----B-----M-o--------M--?----oo--o--M--?BEo--Mo-?----------o?---oB--------B---B----o---oMo-o-M-----oB-o---B-----o-o-?---------?-o--ooo--o--M--M-B-?-o-----o-M---?-?M-----E--------Mo-M---B---------o-ov
-?--E--B-B----E----M-M----------M?---o----B--?----E---o--MM--o-------o-M--o-----E------B--B-?--o--o-?---M----o---o-oB---o-M--oo------MBB---------o----E---?--o---o-------BB?--o?B---o----B-o---M--B-?-Bf
----?---B---o-?--o------?-B---o---Mo----o------o-M?-?-?---o--BoB-o----Bo------?BB---o------?o-?---o--E-Mo---o--o--B--o-----o--------o--o---o-------BooBo-------X---?-M---o--B-----o-ooM---?-?-o-Bo-----f
-----?--o---------B----ooX-M-o---?---o--?----MMo?-----o-----?--oMo?--?ooo----?------------------oMo--M-oo?o---o--B----o----X-M--oM-M-----o--------------M?-o-----Mo--------M-BB-M-Bo-----?-Bo-oo----B--f
-Bo--o-??---o-o--?---M--o-o-?--------Mo----?--o--o-?E--E-oEM----oB--------oo?----?E--oM------M--oo--E-------MT--o---?--M---------o---M--------oM--M-BEM-----o--o---M--E--M----oM-------------Bo----?-?-f
--oo--o---o?o-----BoM----o--------?M-------o??-?----M-----B-?--oB--?------------B-B-------o--o---o--M--------------o---o-------M--BoEoT--o--B---?---o---?-------o--o----B--E-------??---o--oT-?o-o-o-oof
--------o-----o-------------------------------------o----------X-----------------o-----------------o---------------o-o----------------|--------o-----------o------E------------o---------o-----o---o---f
m-E--E-X-TE-----T-----oTE-------T--------Bo----oo-------ET-o-o---------o--T-o-----o-T--To----TT----o-E-o------------T-----X---o--T--E--T----oo-----------B--------X----E-E-----------o----X-T--Eo--X-T-X
XXXXXXX-XXXXXXX-XXXXXXXXXXXXXXXXXXXXXXXXXXXXXXXXXXXXXXXXXXXXXXXXXXXX-XXXXXXXXXXXXXX-XXXXX-XXXXXXXXXXXXXXXXXXXXXXXXXXXXXXXXXXXXXXXXXXX-XXXXXXXXX-XXXXXX-XXXXXXXXXXXXXXXXXXXXXXXXXXXXXXXXXX-XXXXXXXXXXXXXX
