--------------------------------------------------------------------------------------------------------------------------------------------------------------------------------------------------------
--------------------------------------------------------------------------------------------------------------------------------------------------------------------------------------------------------
--------------------------------------------------------------------------------------------------------------------------------------------------------------------------------------------------------
--o---?------------o----------o-o--MBoBM-o-?--o?o?MT?---o?--------B-------BE-B?--o-----o------?-?-?------Mooo-B----Mo-----o-BB----M---M--------?-o----o--M-B--BoB------M-BM-B----?o?M----Moo--------o-?-
-?-?--o-----BoM-----------B----M-B--o--o-o---oo-o-----Moo-o-o-?MB--E-M--?--?---o-o-o---?--o----?--o-oM---o-B--------M----oB?--?-----E--E----BB---oM----B---------M---BB---oMo-o---Mo----o-----Bo--------
-oB-B?o------o-??---B-B-------------oMoo-------M-MB-----?---E-o--M-?-------o----B-------M--B-?-oM----o----B----B-M--o--?-------o---o?--?-X--------o-o--o--B-------B-B-----Bo-------o----oB---o-----oM---
-----o--M-o--o--o----M--BB-B?----M-----B----------o?-M-------?-B----o-M---M--B-o--B-M-----oo-o------M-BB-o-o---o---?--B--oo?-o--E----------B--o--------M-?-o-----o----Mo----B?M-o--oB----o--o----M-B-o--
------T--?---------------o-o---B---ooo---?-?B-oB----?-o-------oo----B----Bo----B---o---o----o-M--B--o---B--oB--M------o------E------o---Bo--o----M--MB------B--MM----B-o-?-o-----oM?-B----o-----?-?--?-v
---M--X--o-----------oE-M--B---o--M-E-o---o--B-o---------o-MM-M-?-E-o--------o--BoBo-o-------o---------------Mo-o-M-------B-MM--??--oB-o---M?------Too---o----B---oMT----oB-oMM-o--o---o--B-ooE-------Mf
-M---------oB--------?---M-----o-o-oM-oo-B--M---?BMB-----------B-?---?---?----------B-B---M?-o------o-ooMo--------oMB----Mo?---M-o--o-------------?---?Bo--B--o----o-Bo-------o-o--------o---M-?------of
-oB--?----------Eo------B-?--o--?-----o-?---o---o--o---oE---?-------------M-------?----o?------o?---M--o-ooB-o-?ooo-------------------------M-------E-o--o----M-B-B--------M-M--MB--o-----B--oB-oo-o---f
--------?-oT?o--B----M-?-B---M-------B------oM---M-Moo-oB-o-------------B-oB?oBMoMo-------M-?-?o--?--o----------o-----MB-?E----?-B---BE-?--B----o-B-B----M---M--o---o-------------B?o--o--o-Mo---M-?M--f
-B------o-M--------------o-----o-----o-M-o?----ooo-oMBo--B-oB----o-----Bo-B--Bo-----o---B?--o----?--o-----B-Mo-Eo----o--------B-B--X--M----oo-Mo---M-M--------Mo?-B-oM-o-----o---Mo-M?oo-BB-----------Mf
----------------o----------o------------------o----E--------oo------o-----oE--------o-----------------o-o---o-------oo---------oo-----o-o---X-o----------o---------o--------o--------oEo------T-o---o-of
m--E---E---o----o-oE-Xo-E--oXo-T-----------o-ToB---T-------oE--EEE---------X------E--o--E---oXE------o-ooo-XE-o-oE-T-E-T---BX---T----T---T--XE-X--o---T--o--MT---EX------------E--oXo-T----o--|--E-E-o-X
XXXXXXXXXXXXXXXXXXXXXXXXXXXXXXXXXXXXXXXXXXXXXXXXXXXXXXXXXXXXXXXXXXXXXXXXXXXXXXXXXXXXXXXXXXXXXXXXXXXXXXXXXXXXXXXXXXXXXXXXXXXXXXXXXXXXXXXXXXXXXXXXXXXXXXXXXXXXXXXXXXXXXXXXXXXXXXXXXXXXXXXXXXXXXXXXXXXXXXXX
