--------------------------------------------------------------------------------------------------------------------------------------------------------------------------------------------------------
--------------------------------------------------------------------------------------------------------------------------------------------------------------------------------------------------------
--------------------------------------------------------------------------------------------------------------------------------------------------------------------------------------------------------
-----B---B-----------------?M--B--B----oM-?---------o--?----------o------B----M------------------------------------o---------------M----------o-------------BM------B-M--?-----------------------o---?--
----B-----------M-------------------M----?------?-M---o-------B-oo-----M-------?------M---B-B----B-oM------o--M--?B------?BM---------------?-B-B----?-------------oB-------oB----B-----o-------------o?-
-------------?----B---?--o--o--M-----o-----o-B?M-----?----------B--------?M--?-------------o------M-----B---?--M-----B--------?-B--o-------o-o---o-M--o-B-------------------------?------------E-o--M---
------M-------B-----------------?-B-M-----------------------oo--------??----?-------------B----------B--oo?-------?-?-M--------------o----------------B---o-?-------------o---?-------?--B-----M------M-
-----------------B--------B---o----o--B--?-?---M-----------o----?-------B------?-----?------------------?---M--oo---------?-----oo-M------M----o---o----------o-----------o-X--?----o-------?---Bo--?--v
-----------ooo----o--B---?-o----B---------------o-MBo--------MM--------B-----o---------o--o?-------B----------o------M---?----E-----o--?---------oo--B?M-??-o-oo-o--o------------------------------M---f
-o-----?--B----------------B-o----M---------?-M------------------M?-o---B--------------o------M---B----------?--M-BB-o--------------------?--o------o-o-?--------o-o---M---------------o-----??------B-f
------B----MMB-?----------------MB-M------M--o---?------M-----M-----M-----B---B------?---B-----------M---------?--------o-M----------------?---------------BMo------?-o---?--?-----B-------??---------of
---------o-----------------------------------------------B?-B------B-----B---?--------------?----?-----B----o---------?----?---o--?----?------------?M-------o-----o--?------o---oB------M----BBoo-----f
--M-------o-?-o--------Mo-----------MMM-----?--------B-Mo--------?---------------------------------------o---B------ooo-----?-?------?----M-----M--------Mo--B----o--------B------o-o??----M------BM--Mf
-o---------------------o-------------------------------------------------o---o------------------------------------------------------------------------------------------------o-----------------o-o----f
m----------o---------------------------E-----------------------------------X----------------------------------E------------Eo------T------------------------------o------------------------X-----------X
XXXXXXXXXXXXXXXXXXXXXXXXXXXXXXXXXXXX-XXXXXXXXXXXXXXXXXXXXXXXXXXXXXXXXXXXXXXXXXXXXXXXXXX-XXXXXXXXXXXXXXXXXXXXXX-XXXXXXXXXXXXXXXX-XXXXXXXXXXXXXXXXXXXXXXXXXXXXXXXXXXXXXXXXXXX-XXXXXXXXXXXXXX-XXXXXXXXXXXXX
