--------------------------------------------------------------------------------------------------------------------------------------------------------------------------------------------------------
--------------------------------------------------------------------------------------------------------------------------------------------------------------------------------------------------------
--------------------------------------------------------------------------------------------------------------------------------------------------------------------------------------------------------
-o--?--Eo--------B---Bo----o-----------------?-M----o------B---------B---M-----------?---M-o-------?-?---?M----X---?--Mo-o----?---o-------M-----------o?-------EM-B--o-------o----------------B-?-?-----
-------M---------------?-----E--?--o--??--o------o-------o--?-----------?--?---?M------?---B------------------o-?-?o-o----B----B---o-?M----B-MB---?------Eo?-------?--M---M-o-M-M-o--------o---o----?---
----o-B-M-----------B-------o?-----?-------------B---M----?---------------B--?---?-?----------?---B---??--------------o--Eo-BMo-?-----o---------------?M-M--M-------o---o----E---M-----??-----?---------
---------B--M---o--B--------o-----?-----o-------o-o----------------o-----?---------oEB--------------M----M-B---?--------B-BB-----------?oM--------------B-------E---------?M-Mo-------M-----------?o----
--M?o?-------o---?----M---B------B--o------------o--o-BB----?---------Eo?---E-o---o-?--o--------B-?o--------?-?---o-----o--------?--?-M-------o----o---?---B---M---------?-------Moo?----?----o-o--oo--v
---------?B--o------?-----------M-----?----M---?--Bo-----------?------?-o---B-?---------------B-----MB-------o---M----?M-?-?--o---oM-----------?----------------B--M--oE--------------?---MX-o-----?-?-f
-?------?--B-----?M?-------?o--M---B-------------M---B---?ooMB?---o----------?--------MM---M-?--------M----------------------?----M-----o-B?--o--B-B?M-----M--o---?----M--?----?---?M--X---------------f
-----B---o----B?----o--------------------------o--------o-Mooo------Bo-?---o------o-----o------------------M--------------------B---?--------B--------M----------Mo--o---------o----o----MM------------f
-------B----------B--B---?M---o--------------MB-Bo?--o--o-------------M-------B?-----?--------------M-------------M--?---?--o-----M---------------------------E-B---o--?---------?----------B-?--------f
--M---?oM-------?---?-----------Mo-M-----B--Mo-----?--?------??--M?--o---B---?---B------------B-------?--------M----o--M---B-?----------------o--M-?M---o-----B----o----o--o-Mo-B--M----------o---?----f
---------------------o----------------------------------o---------------o----------------------------------o----------------------------------------------o--------------------------------------------f
m----------------------o--X------------------o-o------------------------------------------------------------------X--------Eo--------------------E-----------o-X------------------------X-o--------X---X
XXXXXXXXXXXXXXXXXXXXXXXXXXXXXXXXXXXXXXXXXXXXXXXXXXXXXXXXXXXXXXXXXXXXXXXXXXXXXXXXXXXXXXXXXXXXXXXXXXXXXXXXXXXXXXXXXXXXXXXXXXXXXXXXXXXXXXXXXXXXXXXXXXXXXXXXXXXXXXXXXXXXXXXXXXXXXXXXXXXXXXXXXXXXXXXXXXXXXXXX
