--------------------------------------------------------------------------------------------------------------------------------------------------------------------------------------------------------
--------------------------------------------------------------------------------------------------------------------------------------------------------------------------------------------------------
--------------------------------------------------------------------------------------------------------------------------------------------------------------------------------------------------------
----?--Eo-?----B-----B-----o--------B---------------o--------------------M------E----B?---M-----?---------M--------?--M--o------?-o?------M----M------o----------?B-------M---------o---------B-?---?---
-------M--o-----------M?------M-?--o---?--o-----?o----------?-o--------??----o--M---B------------------------o??-M?--o----B----M--oo-?M-?--B-MB---MM--o--M-?----------M-Mo--o-M------B-----o---o-o------
----o-B-B---?-------o--------?---------oM--B-----M---M?-B-?--------o------B?-?-----o-----B--??----Bo--??-M------------oo--oo-oB--B----o--?-----o------?M----M-------o--?---------?------?-B--o?---------
-M-------B------o---------o-o--B--B-o-----------o-o----------------------?-------B--------------BM--M---B----B----------B--B-----------?o----M------?---------?-----------o---o-------M?-----------o----
---?-?-------o---?---?---?-----o-B--M---------M-?o----oB?-------------E-?---E----oo-o?-o----------?o--------B-?--?-o?---------------?-M------o-MB--?---?--------B---?-B-----M?----o-??---?------oB-oo--v
----M----?---o------?-------------?---?--?-M---------B-----M-o----B---?-----B-------------B---------M----Mo---o-?--------?-M--o---EM-o---------------?--------?-o-----o-------------------M?-o--?--?-M-f
-?------?-B------?---B------o--M-----?-----------B----------MB----o----o---B----------MM---BoM-o------M---------------?----o------M-----o--------o-B?-o----MB-o---B-------E---------M----?-------------f
-----?-----?--------o---------?--oM---------------?-----oBMo---?-------?---oB-?---?-----o---?-----------??---------------------o-?-----B-----B-----o-----------B---------------o-------M---------------f
-------B----------B--B---MM--?o--------------MB------o------o-----B-o--------------------------B---oM--B----------Mo-o-?----o-------B-------?----------?--------B--------o-------?------B---BE?--------f
------?-?----M--?---?-----------o--M-----B---o------B-?-?-M----------o--?B---?---B--------o-------?o--?----------------------?-------------------M----?-o----------o----o--BB-o?-----?----?--?----?----f
--o------o---o------------X----------------------------------------------------------------------o---------o---------o---o------------------E----------------------------------------------------------f
m----------------------o--X-------------o----o-o-X---------EX------------------o-------------------------------------------Eo----o---------------EX----------o--------------------------X-o-----o--X---X
XXXXXXXXXXXXXXXXXXXXXXXXXXXXXXXXXXXXXXXXXXXXXXXXXXXXXXXXXXXXXXXXXXXXXXXXXXXXXXXXXXXXXXXXXXXXXXXXXXXXXXXXXXXXXXXXXXXXXXXXXXXXXXXXXXXXXXXXXXXXXXXXXXXXXXXXXXXXXXXXXXXXXXXXXXXXXXXXXXXXXXXXXXXXXXXXXXXXXXXX
