--------------------------------------------------------------------------------------------------------------------------------------------------------------------------------------------------------
--------------------------------------------------------------------------------------------------------------------------------------------------------------------------------------------------------
--------------------------------------------------------------------------------------------------------------------------------------------------------------------------------------------------------
--B?-----o---oB--M--M-o------E---o---------oB------M--B-oo--------?------B---B---o-?--oo-M---o-MBMo-M?--B---o?---?-M---B----?--Eo-----------?-------B?-M??---------BEM?---Bo---o?-B------------o-o--BM--
---o----o-B----o?o----oB--?-M----oM----?-----MoB---oE-----ooB--o---o-------oB--?-o----B--o-------------Eo-B----------------o-o--?-E-??-M--------?-Mo---o---o-E--o-o-B-oM--o----oo---B-M--Bo-----?-----E-
--MMo-------o-B---X-?---------o----B-M----------o---?-------o?MM---M-o-----o-B--BB?-?-oB--E-----?M-------E----------BB-----------BB-o----M-----o--o-------B------o---M----B-o--ooo-E-----o----------BMB-
-M----oB-Bo-B-----------?-?oB?-M---o--T-M--?------o--M---?-M----M----BoB--B--o----------M-----------o-M--B--o--MB-?-----M-B------o---B?---M---B----oo---------B--MT------o-------M---o-B-o-o--o---M?o---
---B-----o----B--E---------o--B-M--oB--o-----o-o--?-B--B--o-E---o-------o-oB---?-Mo--?M---B----B--------------M-----BB-B-M----?-----o--o----B---?B----M?----o------M---B-M--B--o---o-o?--o--Eo?M-------v
------------Mo--o?--B--o---?-------o-oo-M-----?oo----E-----------o--o-B-------o----B---M-----B--BMo--BM-----BM-M-----------------------M-------M----EBo--?----o-----B?-----X-?oo----------M-B----?--o--f
--?B----o?--o-----Mo--M--o------?-M?o---o----M--o?-------M--M-?M--M--B-Eo-----o-M?---o-o---?-o--o-o----MM--M---ooM---oB--------M?-------o?E-o-----o----------?-o----o-M--------B------o--------MM------f
-o--------------?o-M--o-----------o-?----M-------o-?---MM-o-----------?---------------o--BM--E-?o---o---o--o?-----B--o----B?-E--oo?-------MM---o-----o---Bo?-o--M-?-Bo---?---------o----M-M---?---B--M-f
-o-----BE-MB-M-o-----T-M--------BB---B---------B--------------o-ooM------o-----------o--To---B----------o-------E---o--Boo--o-o---o--oM--oo-E-----------------o--E-M----o---------Bo-----------oT-oB---f
------ooT-------------E---B--o---o--o--B---BM-?o-B--?------B----oo--?--M---?M-Boo??-------Mo--o-o-B----o-?MBB-BBB----B--o--oM--------?-------o-?-o-o-?BB-BMM-----MM-----------E---------B--?BBoM-------f
-o--------o--------o-E-------o---oo-E-----o--Eo--oo---------------------------------o---o--o---o-----------oo---o------------o-----o-----o------------o--------T-o----------------E---o---------o---oTof
m-o---M------o-o-o-o-X----T--XoE-T---X-E-Xo-EXT--T----o---------E----X---B-oE----E---E---X--o---T-----o-o-------o-XXXE-------o-Xo-o----o------o-----------T-M-o------o--E--------o------oX-o--T--M--EXEX
XXXXXXXXXXXXXXXXXXXXXXXXXXXXXXXXXXXXXXXXXXXXXXXXXXXXXXXXXXXXXXXXXXXXXXXXXXXXXXXXXXXXXXXXXXXXXXXXXXXXXXXXXXXXXXXXXXXXXXXXXXXXXXXXXXXXXXXXXXXXXXXXXXXXXXXXXXXXXXXXXXXXXXXXXXXXXXXXXXXXXXXXXXXXXXXXXXXXXXXX
