--------------------------------------------------------------------------------------------------------------------------------------------------------------------------------------------------------
--------------------------------------------------------------------------------------------------------------------------------------------------------------------------------------------------------
--------------------------------------------------------------------------------------------------------------------------------------------------------------------------------------------------------
-oo-o-o---X-M----o-E---B-M-----o-oM--B------------E-o-----?--BM---o--XE-------E-M--To--T----o--T-B-----oM-EX-oTB----B---E---E-------?-M-B--EBoEE--ToM-E----o---o--o-o----------o------E----E---o--------
--M----E----o-----------EooM--o---oM------EMB------BoT-o--------BBE-------E-----o-----oX--Eo-----o?--T-To----------oo-oE--o-X-o--T-o-M--o----o-M?-XT--------?--T------------o-oXXoEM--M-?-o?--?---------
----o----E---o--M-------B----X-----o-?---BM-o-X--------oBo-BM--B----M-E-o?B-E--XE-T-M---M-M--B--B--??X-----E----B-----o---B--E-----o--M-?--T-E----------?T-----|M----o------MT----MoM--oo----------E----
----ME--T---Xo---------T-M--B-ooE-ET-------------?--M-oooM-ooB----------?---Xo---------E---ooo---------B---?---------B---Mo-E--?--?----------X--oMM?E-------o-o-------B?-?B----?-------EE-o-T------?-B?-
-----M--XMo----------B----o---M-B-?-?-----o-M--M----o-------oo--To-----B---T-------?o?EB---E----o-----o------?-----o---M----To-------?BB-B-oE------o-?B----?M-o-------o---o----o-------M------------o--v
--B-E-E------?--XoE---BEM--?-o-Eoo----Mo----oE?o--?-----E-oo--M--B----ooo?-----X--Moo-?-oEB---B--M---T?--o--o-?--M-----o--T----------o----------o---TooXE-Too-?--------T-----o-------M-oB-E--E--Mo----Ef
----BEM-o?-----X-M--M--B----T-X---EBo-oT---------ooBB------o-M---o-B-B--Eo----------To--------o--o-----?-ME-o--M-oT?-o-T-M-o-B-o-----Too-------o-T--XM-----ET-----EB------o-------o------o?--------M-o-f
---T--o-?o--EE-XTo-------B-----o--?-o-TXM-BX------o----------o------------Mo--------X--?-o--------o---M--o-E-------------o--o---TB-M--------E?o?M-----BB--o-----B---o--M----o-----MEoM--o-o---M-oo-o-o-f
--o-o-X--E--XB---------oB---o----T-M--|------------M--B-T-------E--T---------------B-B-------------E---X---B-----o-T----T-E--o---------ME------------Bo----E-B?-o-----B---------------o--?E--T--?---M--f
---BTE--?----o-----o-o--o-o--T-T---o?--Eo---E--To--o-M-B--M-------T---BEB-T-------o-Eo----M-oo?Eo--T-oB---B------TE-T--MX-T---E---ooBT-----------E---oo-oT?M---ETM---M----EM---o---?-T-T-o-?------B-oo-f
---o----o----o--E-------T---o---o---o-----o-----T----o-------TE---------o-----------T------X-o----T---oE--o--E-o------------o-T-X-oT-----o---T----o--------o----|o--oo------E-----Eo----------o-----E-of
m-BX--E---XX-EToTEE-X--oXE-------T----o-E-T--Eo-|oE-o-XX-B-XX|--------o---EoXT-ooE--X---X--X-EoEo---ooX-------T-------XX-E-T--|T-o-|-----X-T-X-E----o----o-oE--------ME-----X--ooB-M--------o-X------TTX
X-XXXXXXXXXXXXXXXXXXXXXXXXXXXXXXXXXXXXXXXXXXXXXXX-XXXXXXXXXXXXXX-XXXXXXXXXXXXXXXXXXXXXXXXXXXXXXXXXXXXXXXXXXXX-XXXXXXXXXXXXXXXXX-X-XXXXXXXXXXXXXXXXXXXXXXXXXXXXXXXXXXXXXXXXXXXXXXXXXXXXXXX-XXXXXXXXXXXX-X
