--------------------------------------------------------------------------------------------------------------------------------------------------------------------------------------------------------
--------------------------------------------------------------------------------------------------------------------------------------------------------------------------------------------------------
--------------------------------------------------------------------------------------------------------------------------------------------------------------------------------------------------------
---E---o--BE--B--?-o-----T---M-----o?-T---------M--Bo----X----E----------------o---B?---o-M-E--o----ooB---o-E---B-o---T--E?-T--M-?----E--E----B--E-T-E-o-Mo----??---------oo--Bo----E--o-------E----M---
-oE------oo--ooo---??--E------M-E----------?---E---o----E---M--o-----o-EB-o-ET--------M-?-----MEE-M-----o----M-M--B-------oE-M-oE-BB-B--o-o--o------E---o--T--o----EEME-M-o?-----E-?M-----T------E------
---BBE?-----o--o--o--------T-----TEoEo--E---------E--?-MB---oo-M---M---------|-E---o--oT----T--------MT---BM-ooo--o-o-oM-----oo-T------o--E-o-oo--M--B-E-T-X--------M-BM--?--oEB---o-M--X-|oE-?-----M---
-E-o----oT---X--o----?o-T---o--EM-B-B-Mo-M-----M-------o----X----?--o---E---o-----?-o-----?M-M--BT---o---X-oEo--T---------oM--BB------T-B-----EE-----oTBo---X----o-oo---?o------X--B-o-------B----oB-Bo-
--Bo-ToEo--------Mo--oM--ETM---M-?oM-B-----E?------X-M-E?-oM---B?-M?M--o--T-----oo----E----o---?-----------?-----M----?-MX--o---B--T-EX----?T----E-?X--o-----E----o-o----------T-B--oM-Eo-----EE-oo-B--v
--o--|?-o---o-B-oo-o--oE---o--Mo-oo-----M--Xo?--oB---o-MooMo----o---oB--M--M-B-M---TM------E-----o--o-M--o-ooo---o----o?---To-------M-----To|o---T--X?-oM----TX--ET-E-BB------E--o---o-----TEE---E---oof
-------o-TM-B----oE-?o---XBoT--o-MT------BM--------T----B--M-o---?M-?o-----o-o-oM---o------M----B-------------?--oM----o-----B-o----------------------E---o--X-?o--M?-o----B-B---X-o--oB--E------------f
--T---------o-B--?--oo--o--o-?-o---o-----o-T-?---oo-o-?-oM------E--B---o?---M------?-B-MM---------B-E--Eo-----o-----?----------o--------MMM--BBo---To-----o--------o------Eo------------ET-E----T-?---of
---T?ME----B--o-T-M-o-----X-M-TE--T-----EB-----Eo-M-B-----B---M--?-o----o---o-TB-----oE-----o?---?o--E--?-o-EM--MT-------o-Xo--X-o--o------EMoo------X-MM-----BEo-X--oo-------o--o?-?-E---B----o-?o---Bf
--o--o------oo------------------o--------o----?--E----o-M?--oMo--o-Eo----B-E---ooo-----ET-----?---o--M-----o-oT-o-------M----o------o-o--Eo---E-----B-T----BTo--TB--T---o-----o--------M-T-T---X-----B-f
----o--o---oooo-----o-o-------o---------------------T---o-------E---------E------o-Eo-----o----o-TE--------------o-T--------E--o---o------------o-----|-oE-----------X-E---o-------o-E----X------------f
mo---Mo---X---oo---o-o----X-----T?o---Eo--T----Too--|--XEX--To-oT-----E-o----T-BE---TX---o-?--o-oXT--o-TT-----To---XE-ooT-E----X-Bo-o-oT--X-E------------?oX----EE-?-X--?--oT-o---oE---T-T-o-E---ET-E-EX
XXXXXXXXXXXXXXXXXXX-XXXXXXXXXXXXXXXXXXXXXXXXXXXXXXXXXXXXXXXXXXXXXXXXXXXXXXXXXXXXXXXX-XXXXXXXXXXXXXXXXX-XXXXXXXXXXXXXXXXXXXXXXX-XX-XXX--X-XXXXXXXXXXXXX-XXXXXXXXXXXXXXXXXXXXXXXXXXXXXXXXXXXXXXXXXXXXXXXXX
