--------------------------------------------------------------------------------------------------------------------------------------------------------------------------------------------------------
--------------------------------------------------------------------------------------------------------------------------------------------------------------------------------------------------------
--------------------------------------------------------------------------------------------------------------------------------------------------------------------------------------------------------
----o---o-----M-----------B?------?M--------o-----o-----o--M-------B---------o---------E-------B---o-------o-----?--B--?o--------------?--o-----o--------------------o-----------------?----------------
---??-?------?---------?----B---o-----?-o----o-M--?o--??-B-----?-----?----------------o-o-M-------M--o---------M-o------M-M---o----?-----o--------?------M---------------------M-?-----------------o----
---o-o---------Boo------------o?---?-----------o-----?--?--MM------------B--oMB-----Boo-------?-M---B-----?-------------------B-------------B----?--B-?B-------------?--------------B?-----------B------
--------------------?---M-------oM---------B----------oo--M----?--------------------------M-------M---------o--o-o--o--o-?----oM----------?--M----?---------o-------------M-?----BB----B--?---------o---
-------M--------Mo--------B??-B-----o--oE--------M----??---------?-------------------?-------B------E---o---M--------o-------E?------?------B---?--------?------------B------------------?------B-?-o--v
------o-??-?--Mo------M---------?-o-----?--M--------------M?--?----M-----?-B-------------------?M----o-----M--------B--------?----------B----M----??--------o-BB--?-MM--------?-B-Mo-----o----?-o--B?--f
-oM?-------o-?oBM-----------B-?---o------------------o--M---?---------oo--B----o----M---oB?---o---o----M----M--B-----------o--B-----------BM-----B------o--o--o-------B---MoB--------o----------------of
---o-----o-----------B--------------------------BB----M------MB---o-o------------------------------------o-----------o-----------BoM??M---------?-M-B---?--o----------------------oB-----M--M-B-----??-f
-o---M--?-----?-----?o-------------B--------------MM-?--------------BB-o?M-----B----o----?--?------------B-------B-----M---o-----------------------------------o---------M-M?--o----M-------o---B-----?f
------o-----B---------?-B---?-------------?----------------o----M-----M---?B--B------------Mo-B----?-M--M--B---------------------o--------?o-B-------M-------------?-----------B--M--------------?----of
---o---------------------------------------------------o-------------------------------o----o---------o----------------------------------------------------------------------o-------------------------f
m------------------------------o--------------------------------o-------------o----E-o-----------o----------o------------------o--------o------------o-------------o-o-------o-----o-o---o-------------X
XXXXXXXXXXXXXXXXXX-XXXXXXXXXXX-XXXX-XXXXXXXXXXXXXXXXXXXXXXXXXXXXXXXX-XXXXXXXXXXXXXXXXXXXXX-XXXXXXXXXXXX-XXXXXXXXXXXX-XXXXXXXXXXXXXX-XX-XXXXXXXXXXXXXXXXXXXXXXXXXX-XX-XXXXXX-XXXXXXXXXXXXX-XXXXXXXXXXXXXX
