--------------------------------------------------------------------------------------------------------------------------------------------------------------------------------------------------------
--------------------------------------------------------------------------------------------------------------------------------------------------------------------------------------------------------
--------------------------------------------------------------------------------------------------------------------------------------------------------------------------------------------------------
------o----------------?-?---o--o----------?----B--B---o------------?--?-o-------M--?-----o----o--o------------oB-oB-?--------B-ooo-M-o--o---B---o--o-------o------------oB?------------M----MM---M-----
--?--o----------B--------------o-------B-------o---------B-M-M----------B-?X-----------?------?B------o----Mo-B-----------------??-------B---o-------B-------?---------------------------?-----M-E----B-
-M-----o-o-??---o--B----------------oB-----?------?--?--------?B--B------B----?-------------------?--oM----o----M-o---o-----oB-------?--M----MB-----------?----o-B-oo-----B--B--?-------M--B-----?---B--
-o?-?----o--o?B-B----?----B--------o---B?----M---o----M----------------B----------------B-?--?-?--o-----B-----------------M----?o---------------M-------o--------o----------M----?--?--o-------o--M-----
-----?-B-M---------------------------o-----?------M?-------o---B--o---------?-----B--------o----?-o-------o-B--------?---o---B----------------o---B--M-----B--o---BM----?------M?-------------------Mo-v
--M---o-----?----------?---o-------B--M------MBo-?-----------?-----o--?-------M----o---BM?-----o-o-o-------M-o-o----B----------B?BM-M-----B------------o?-B------o----M------o----------?M--?BMB?-M----f
----ME--o----------------M-oo?-?-M---?--M--?------M--M-B----M---B--B--------?---o?M-----------------------o-----M-?--------------o-------o------M---------------o---B---?------Mo---M------?-----o--?--f
--o--M-o-----------M--------B----------------o--M--------o------o----M---------o---------?-MB----B---------------o----o------B-----?------B-------?M--oo----o----M-----------M-----?oo--B---o---Mo---o-f
-----------B---------B--?----B------M--o----B------------------BB--o--?--------------------o-M?-o-----------------o-----o--------------o---------------------------o---M-----o---o---?-M------------?--f
-B-B--B--B--B----B?-------o----?---------o----------?--------?-o--------?------oB?-----?---o-o--------------?------BM----M--?-o-?--------B------------------M--------M?o-----?--M--------o-M---o-------f
-------------oo-----------------------o-----------------------------------o-----------o-----o--------o-------------------------o---------------o--o---------------------o-----o---------o---o----------f
m------o---------------------------o-------------------------------------------o--o------o--o----o----------------------------------o-----o------------------------------------o-----------------------X
XXXXXXXXXXXXXXXXXX-XXXXXXXXXXX-XXXXXXXXXXXXXXXXXXXXXXXXXXXXXXXXXXXXXXXXXXXXXXXXXXXXX-XXXXXXXXXXXXXXXXXXXXXXXXXXXXXXXXXXXXXXX-XXXXX-XXX-XXXXXXXXXX-XXXXXXXX-XX-XXXXXXXXXXXXXXXXXXXXXXX-XXXXXX-XXXXXXXXXXX
