--------------------------------------------------------------------------------------------------------------------------------------------------------------------------------------------------------
--------------------------------------------------------------------------------------------------------------------------------------------------------------------------------------------------------
--------------------------------------------------------------------------------------------------------------------------------------------------------------------------------------------------------
--Moo---o---Bo---oE------o--E-----o----?--o--o---M?B-E----o--??-o-?------?M------E---B-------BB-?---o--------------o-o---------?--B---o---M------------o-B----M--B-o--oo-oBM--M------?Eo-B--o-M--o---B--
-------Eo--------MBo--?-----MMB-EM----?--B--M-------o-o----o-o------?-B----------------?-?B-M-o-o---------?--------M------o-o-?-o------?---------Bo--?--o-----o----o--o-B------o----M--oE---B---------M-
-?--B--?-----o-----o---oB?M-oo-MB----?--o--o-E----?-----M-?o??-----T--o--E--Boo----?---------oo--M?-?-----o-BB-?-?o---oB--Booo--o---MB-------?-----o-o-------?-B-??--------------?----o--M-oo--o---??---
---?o------?oB--Bo-?---?-o--------M-----oMM--M-B------o--M------?---?M-M------oo---oB---o------ME-----BoBB-B-----o------B--o----?--?-------o-o--------oM--?---M----B-M-??-oB--?--o----E-------------ooB-
--?-oM-Mo-Mo-----B-o----oBB----Mo--o--B-?--oo----oM?-?------o----o-------o-----?-?--oM----oMM-?---o----?-o--B---o-------------?-o---?------E----------o-----o---?-----?--o-----------o--E-oB--o-EMB-?--v
---o-oo---oo----------o-------o-o-o----?-oMB-----------B?-MM---M-----------oo--o--?-Eo----o--?--MB--o---o---o-o------?-M------o-oM?---o---oT--?M--?-o-o--M-oo-o---o-Moo--------oM--E?---?To-B--EM-o---Mf
--o---?o-?-B--M---o-o---o----BM-----o---M-----?M-ME-o---o-------Bo---B-------B-M----M-oEo-----------??----o------oMBM----M----o-o-o--oB--E?X----MM--MMo--o-o---o----o-o----o---o--MB-M---X---o--o-M----f
--Bo-B---o-oB----?o-----B---E---oM-------B?-------B---o-o--o----oo--o--?-?------o----B--oM---o----?--o--?-oo-o---oo-----M-E------E-------M--o-B---B----------o-o----E---BBM-oM--M---B-BB---oM-Mo----?-Mf
-----o---?-M-?----oM-M-Bo----B--o-o-----?oo----?---M---------------M?-?-----?-B--B-Bo-E-----?-M---o---E-o-------o-o-?-------M--oo-?Mo------B----o-o---M-----B-?M---M--M?---?M--M----o---------o???-----f
---B--------?o----?-?-M----M-------o-o-M-o---------oBBMM-o-o-B-?oB-----oB-------oo-------M---?--B--o-o--o-?-M-M-----oBo-BM-M-?--BB----B------?o---M-o-------o---M---M?o----o--o--?-oo-o-EB--o-o---o-o-?f
----T--------------o----oE-----------Eo-----o------o-o-------o-------o---o---------oo------o-o------o---------------o----o-o--------o--------o--------o-----o-o-o-----o-oo--o---o---------------------of
m---|---EEo-oEToo--ToE-X---E-M-o--E--T-X-Xo--E---T-oXE------T------E---T-o-o-T---o---E--o-X-XXE-oo----o-E--------EX--To--TX--o-X----M-X----EE-----E-o----------X-E---------------X--X---T----E---E-----X
XXXXXXXXXXX-XXXXXXXXXXXXXXXXXXXXXXXX-XXXXXXXXXXXXXXXXXX-XXXXXXXXXXXXXXXXXXXXXXXXXXXXXXXXXXXXXXXXXXXXXXXXXXXXX-XXXXXXXXXXXXXXXXXXXXXXXX-XXX-XXXXXXXXXXXXXXXXXXXXXXXXXXXXXX-XXXXXXX-X-XXXXXXXXXXXXXXXXX--X
