--------------------------------------------------------------------------------------------------------------------------------------------------------------------------------------------------------
--------------------------------------------------------------------------------------------------------------------------------------------------------------------------------------------------------
--------------------------------------------------------------------------------------------------------------------------------------------------------------------------------------------------------
-o-----?---?-----M--M-----M--M-------M------M?-M---o--?-------------------?o-----B-----------o----M-------------------B-----------o------B-------------o-B--------B---o---M----------o?--?--?-----------
--M-o-M--------?--o?--?-?M---o-o-----------------M-------M?-?----B?-----------------------?----o-------------M---M-------------B?---------------M---B-?----o-o--B----?-??-------------------------------
-------------M---?--o------?----Mo--B---BB-?----M-----B-------------M-----M-?--o-?--Mo-?-o---oM?---?--M----?--?------------?------E----E----------?----M?-------o-B--------B----o--?M---------o--M------
-B?----B--?-E----------------------?---M----o-B-----?--------?----Mo----?-----------------?--o------------------B??-------?-M--?--M---o?---------?-------------------?-------?--?------??-?--M-M--------
---M?-------B------M-o?------o?o--------o------?-------------------------------ooE?-----??-----???--?--?-------M-----M?---------?------------?--?-MM-----------------------B------?---M-----?--------?-v
---o--?---------------o?--M-?----?--B----?----------M-M-?-o-M-----B------?B-----M?-----------------B-----o--o-?----o---?-------?---Mo---------M-------B----------------?B----------o----o-M-------M----f
---ooo-o----o---o--?o?--------------------------M---------M---------o?M-B----------------M----?------o-----Eo---o---B----------------E?--------------------?----oo----------M-B-?------?-B-------------f
---------o--M--?-?---------------BM-B-?-?Mo------E-Mo-----o--o------?--M--?-----------o---o?-o-?-------------B---------B----M-M---?-??----E?---?----------?-o----o?--?----M--Bo---B-?-----?-B----M-o---f
-----?--B-B----o?--M---Bo----o--Bo--------?-----?-----?M-?-------BM---------?----?--B?-o-----M--o?------B------?-------------o---B--------B--------o?--?-M---??M------o--------?--------BB-----o--M--?-f
------------B-?--o----------M---o------M---o-----M--------o?--------?---------oB---?o----?o-E--o--?--------?--?-?-?-oo-----B------o----B---?---------------M----MB---------?-?---------------?-----B---f
----------------------X----------------------------------o--------o----------------------o------------------o-------E------------------------------o-o------------------------------o------------------f
m-o------------------XXo-o------o-o-o---------E-----o---o-------o---------------------o-----o----------X------E--o--------E----------------------X-----E-----------------o--------o---o--o----o--------X
XXXXXXXXXXXXXXXXXXXXXXXXXXXXXXXXXXXXXXXXXXXXXXXXXXXXXXXXXXXXXXXXXXXXXXXXXXXXXXXXXXXXXXXXXXXXXXXXXXXXXXXXXXXXXXXXXXXXXXXXXXXXXXXXXXXXXXXXXXXXXXXXXXXXXXXXXXXXXXXXXXXXXXXXXXXXXXXXXXXXXXXXXXXXXXXXXXXXXXXX
