--------------------------------------------------------------------------------------------------------------------------------------------------------------------------------------------------------
--------------------------------------------------------------------------------------------------------------------------------------------------------------------------------------------------------
--------------------------------------------------------------------------------------------------------------------------------------------------------------------------------------------------------
--------------------B-BM-------------B------o----M-o-o----o--------o---BM??-----------?------oMo--------oBB----------o---o----------------M---B--------??------M-?--o-----B--------------------o---M----
-M---------o------o------o----------------B-----B---B-o-M-?o-?---o-?--?-------------M------B------M----?-o---?-----------M-------?B-o-------------?-o------------------------B----------------B---------
---------?-B--M------------o------?o--------M-----------o----o---------------??-----------------?--oM--o-o--o-o-----B--------------?--M-----?----B---------B----X?M---o-?---oo-o--o--M-?-----M------M---
---?----M--o----M---B---?M-?-B--?-o?-------------o-B--?-o----------B?-------B--M--------B-----------------B-----o---------B------B-----?------o-M-------------M-----M-------M--------------B------------
--------------------------------------?--------------?-?---o?-----?-------------B----?--------?---?--o--M------------?--B-----M?--------------------MB-------B------o------?------MM---------B--oo---B-v
----------E-----M-M-?--------------------?--o------------M-o---?--o--B?---?---------------?M----------------------M-------o-o?---------M--?----M--?-----o-o---o--o-------M--?-M--B------B--B-----B--?-of
------?---B------------?------oBE----?-----M--------M--?--------?------M------B----B---?-------?-B-M-------------o-----o--------oo---?-------o--o---o-?----M------?-o-----?----M--B-B-----M-o--M----o--f
----?--Bo-------E-----M-------M-B----------------B----M---?--M-------------?o----o----B-?----B----------M-----B--oM--?--B------M----B-M-oB?----??----M----------B--o-------?-------M-----B---??-M------f
--------------M-B---B--------o------B------B------------------?------M---------------------o-o-------?----------oBo-------?-B----M---M-M-----?----------o?---------M---MB------------------------------f
----------?--?oM---?-----?----B-----------M----B----o---------o-----M--------o--------?--M---?-B-------------------------------------------------B----B------------o--B------------B---Bo--B----Mo---?-f
---------------------------------------------o-----------o---o--------------o-------------------------------------------------o-o---------o----------------------o----o-o------------------------------f
m-------------------------------------------------------ooo-oo------------------o-------o-----X----------T-----E----X-------------------------E-E--------X---------------o----o----------X---------o-o-X
X-XXXXXXXXXXXX-XXXXXXXXXXXXXXXXXXXXXXXXX-XXX-XX-XXXXXXXXX-XXXXXXXX-XXXXXXXXXX-XXXXXXXXXXXXX-XXXXXXXXXXXXXXXXXX-X-XXXXXXXXX-XXXXXXXXXXX-XXX-XXXXXXXXXXXXXXXXXXXXXXXXXXXXXX-XXXXXXXXXXXXXXXXX-XXXXXXXXXXXX
