--------------------------------------------------------------------------------------------------------------------------------------------------------------------------------------------------------
--------------------------------------------------------------------------------------------------------------------------------------------------------------------------------------------------------
--------------------------------------------------------------------------------------------------------------------------------------------------------------------------------------------------------
--o-?--o--E-----o---oE-B---o------------oT--M-------------?---o----M---o-ooXo---------o----o-o---M-?--MoTM-----o---E-EoB-o---o----o---M-T-EEEX-o----o-EMT-o---?-T--E----M--o--M--BEBo-o---B-o----M-T----
---o--M-oB--T-M---o?o?o--T--ToM?-XEB-o---|--oo--o-----M-----o---E-M---oE--?-o---ME?o----------E-----------E------o--o----EE-oo---o--TBoE--?---M---E-T----o-o-M------o---o-o----B-o---B--------o-?----o--
------o---M--o-MM---o--o---?--oo------EMB-o--oE-BXo-E--B--------?-----M----o-----Mo-E?oo--B-oMMB------oo-------B--------E-?M---ME----oo---o-o-o--oM-----------------o-B--?--MEo---Mo--E--o------oo?-o---
-T-----?--o--Bo-----E-X-TEo-------T--EToo---E--Eo--o-o-o----------oo-Bo-o-o----To--?-o--EX-Bo-------M---ooooB-o---o----T--oo------o-?B---?-X---E---------o---?oo---E---EE---oBo---o----M-Mo---B--To-----
------?----------------o-----TMoo----M---E----oX----?----T--oTB------oE-----o?----To-BBo--o--E----o-o----ETBo-----Bo-B----?-----------B-----oETBMXB--o-----o--BE----o----M-??---M----oM---E-oE-EM-E-EM-v
---o----------M-E---Bo-----o--o-o-B--o-----o-E-X---M----------oM--E--?------o---M-------o-----o-M-----M--M--------o--o----o------o-------TM-----o-o?-oM---M-o--T---B--oo---o--E--X----o--o-oBM-?-------f
--EEEo------------o----------o--o---oM--o---T---To--EEoo--B-------B---o-----BB---------T--B-BT----oB-------?----B-o---?-Mooo--E---oMo?--B------E-----B-----------?---o-E--B------------T---?--To--Eo---f
-----oB?--------E?o----------T-?M-o--o-----o----------oo-Boo--MB-?o-----BE--o---E---------o-------o--o-----o----o--E--o-o-------E-E----?o?---E-----B----------B-T---?---o---oB---T-o------B------o-o---f
--M-oo---?-?-o-T----BB---M----B-o--oo-----oo----BE----E-o--o-----ooo-B--o--E-?--------------TB-T------o-------B---BM-T--?M---------E-o-------?---B-----B------o---M---?B-o-----BB--oo-----o-----Eo---B-f
-T-M---o-----X?|?----o-oo---?----E----?o-E---B-oo-------o---M----o--M-oB--EM-------o-M----o--o---o------o-----oT---o----oo--B------B--o---ooE--E------Mo-------B--o--?-oT-ooo--o-E--XBo-----oM-X---E---f
--E-X-----------o----oo------o-------o-------oo----------X--oo------o--o--X--o---E-o---o--o-o---E-T------o-------------oE----o----------E------------o---E------------X-X-------E--o-------------------f
m--oX---o-------T-E--EooE-Xo--TToTEo---E-o-X--------XM--XX-o-X?T-XX--oo--oX-ooTT----To-MEE---TE--oXTEMo-To-T-----E-Eo--T------X-----oToTTo----E-oT-o-X-o--M--oMT-----E-------o--X---EEo-----o--------?-X
XXXXXXXXXXXXXXX-XXXXXXXXXX-XXXXXXXXX-XXX-XXXXXXXXXXXXXXXXXXXXXXXX-XXXXXXXXXXXXXXXXXXXXXXXXXXXXXXXXX-XXXXXXXXXXXXXXX-XXXXXXXXXXXXXXXXXXXXXXXXXXXXXXXXXXXXXXXXXXXXXXXXXXXXXXXXXXXXXXXXXXXXXXXXXXXXXXXXXXXX
