--------------------------------------------------------------------------------------------------------------------------------------------------------------------------------------------------------
--------------------------------------------------------------------------------------------------------------------------------------------------------------------------------------------------------
--------------------------------------------------------------------------------------------------------------------------------------------------------------------------------------------------------
------o-Bo----B------Mo?-----B----MB--B-o---oo----B----?-B-o-----T-ET--E---MT-----------X??---M-oo--o----?oBoB--?T--M----E?oE---------?----?-Mo-o---T--o----?-B--o------o-T-o-?--M-----E-------o---T----
-------Eo-----o?-M--Eo---oE--o---T---B----?-o--BM----T-o--o-----------oM-o-------o-o--oM----B-o-o---M--E-oE--o--------------------------------o---oE----------o??-----E-X-------o----o-?E--o---B--------
-T------------?-Mo---M--?---E--E-|---o?--?--o------o--ME---?---E----o----o-EEB-B------oo----------M?o--B---o-M---E----?------o-M-o-------?-X----M---o-?-----oo-----oEo-o--E--------oMM----?-B-?--B------
-----oM---M-M---o-o-?----E--X-TM------o-------------oE---B------B--XM----o---o-o-oBo---B---X--To-----------o-o-TE-oo--o-------B-Bo-----------E--o----o------M---o-X-----o-?oo--BME-----EE-oE--o-B----B--
-------Eo---o-X----o----?---X----BT---E-----B----------?-oX---o---E--T-oE-oM----M----?-o-Eo--T-o-------------?-|?-o--o-----X--o---T---Eo----M--B--oo---------o---M-Eo--oo-o---?oo-B---o---X--o---o-----v
-----M-------B---M-----o-----o-?B---?TM-BE---o--??o-o--o---M----------?-T-?oo-M-oo--Too---To-----o--------o-M-------------------X-------o---oo-o----?-M-?-ooB----oo-?B------E?oo------M-E-XM--E-To----Xf
-MMB----o-M--o---o-E-E----?-o------Mo---o-BE---E------?----oB?---o----o----ET-o--X---M--T--B----E-----X-oo--o---?-E-M----BT---o---o--------o--E-----o---------TEB-o-----o----o?---E-B--------E--|------f
----?o?-o-o---------T--oM---E-------------o---X----M-Eo-B-----M-o-----MMT-----o------o---oM--oE--E----X-oo-E-----o---MEE---EMoo-----o--?-M-----------M--M---o---o-E-X---T------oo-?-o--TB---------E----f
--oB------o----o-M----TB-M--Xo----o-B------?-E-M--o--M---E---o----T-------E-M?M--oT---o--Bo--?-o??---------M-?---o--Eo-------o-?M-E-X--o-oooE-o------o----ME-M?EoE-------E-oTo-T-----o---B---XXEXo-To--f
--Bo-EE-----oo--E----T|--o?-----E---oT-----o----B-E-o--o---oT-E----E?T---B---o--o-|--B-M-o--------BME-----B----o---M---B--Eoo-------X---ETM---o-T---?-o---o----?E-EEB-BM-----M-----B-?-EE-?----?--o-oT-f
---------o-E------o-----------o-X---o----T------oo-------T--------E---o---------EE-----o-------o--o------------o---o-o-o-E--------o-X-----o-----|---o---------------oo-o-----o-o---oE-X--------ooT-----f
m--X-T----T----o--T-T-X---T---o-X--E---ETX---X------o-B--XT---T----------EX-ETo-----T--T--E--E-oE---T--ETo-o----Xo---XETXM--T-oT--E--o--oM--X-E-X-X----T---Eoo--B-EXX--E-oE-------TTMEX-o----E-TEX----TX
XXXXXXXXXXXXXXXXXX--XXXXXXXXXX-XXXXXXXXXXXXXXXXXXXXXXXXXXXXXXXXXXXXXXXXXXXXXXXXXXXXXXXXXXXXXXXXXXXXXXXXXXXXXXX--XXXXXXXXXXXXXXXXXXX-XXXXXXXXXX-XXXXXXXXXXXXXXXXXXXXXXXX-XXXXXXXXXXXXXXX-XXXX-XXXXXXXXXXX
