--------------------------------------------------------------------------------------------------------------------------------------------------------------------------------------------------------
--------------------------------------------------------------------------------------------------------------------------------------------------------------------------------------------------------
--------------------------------------------------------------------------------------------------------------------------------------------------------------------------------------------------------
----Mo-B-o-?---?--------oB-?o-M------o-o--?----o--?-?-----o--B-?-?o-ooX---?-o-?----?--o-M?o?----T-o-o---B--o---?----o-BMM-B--M------EB-----B-------E---??--?-MM-M-------Mo-BoB----?-----o-----E------B--
-?---?--MMoo---o-M----o-o---o?-------?-?--o-Bo-oo------M----------B-----------o--M---Mo---M-o----------o-----oMo-M------o---?-o---oBM-------oMM------?M---------o?----------o-MM---?o-----oE?-----?---B-
-o--E----------?---------------o--M-o---oM?---M------?B-M-M-----B------??--------o-o?--------o--M--M--B-?T-o-------ooB----BB------?--MM--M-?B------B-o----M-oo--o-o------M?B------Moo---oo---MM-M---M---
--B---o-o?-Moo------o-o-ooM--------Bo--B-------M-----o--------M-o-----------oo-oM----o-----?-----B---M-o-----oB--------o----E-B--o-----o-o------?EB--M-oo--Moo--o--M------o---------M--?-oBoT--o--o--E--
------BMooM-o?------o---o--M-----BE-----------B-----T------------o-B-?-B------E----M---??---E-o---o-B-B-?--o--o-M--oE--o-B?-B--?---BMo--o----M?-o?-?----?-----?---o----MBMB---?o-----o--------o------M-v
--M-----------Mo--Bo--BE-o-o------?---?-oo-------B---M-----o----------B-o-oM-MB---------o-BoBoo---o--o--o--M--------?-o--o----?---M-------o-E-oo--o-M--------?-o-----M-o-o------BMoM--B----------M-----f
----??T-?----o----o----?------o-oo----oE-Mo?MMM---o----M-------?----?---oM-----o--o-o----oo--oBB-----o---B-----oo-M-------------E--?o----o-??-----ooo--?oo?-oo-BB-----M--?-?-M-?o------B-----o--E-----of
-----o-----oM--?BB----M-?o--oo-M--M-----M---------B-T---B?-----------------B---M--?---B-----------B-o--B--------B----------o-MMBB-------o---o-B---------M-o--------oo--o-----oo---?B------?-----M-----?f
--B--M------------o--?ooo--M---oB------o-E--M-o------o-E--o----oo---?--oEo----B---oo---Mo-------------M-------------o--o-E?-B--o--oooMM-M--E--o------M---M---B-o----B-----?M---------------M?--o-o----of
-----o---??-------o------MM-------oo-B-o------MoBo-BooB--o----o--------M--------M--E--oo---?-MMB-?-Bo---?--o-Bo-------o----B---o-------?--BM--o---------?--M---M-?------oT----M--BMoMo?----o-o----M-?o-f
-----o-------------------oo----------o-o--------------oo-o--o-E-------------o----oo-o--------------------------------o---------o--------o--o----oo-E-------------------o---------------T-----------o---f
m--X-X-T-E-o--------E-oT-o-----E---oTToX---X---o-EE-X--------ETE--X--T--X-------------oT-----------T-E-----------------TToE----o-M---------E--------E---T---ooo----ooX--T-E--E-----o--oX-XT-X------oTE-X
XXXXXXXXXXXXXXXXXX-XXX-XXXXXXXX-XXXXXXXXXXXXXXXXXXXXXXXXXXXXXXXXX-XXXXXXXXXXXXXXXXXXXXXXXXXXXXXXXXXXXXXXXXXXXXXX-XXXXXXXXXXXXXXXXXXXXXXXXXXXXXXXXXXXXXXXXXXXXXXXXXXXXXXXXXXX-XXXXXXXXXXXXXXXXXXXXXXXXXXX
