--------------------------------------------------------------------------------------------------------------------------------------------------------------------------------------------------------
--------------------------------------------------------------------------------------------------------------------------------------------------------------------------------------------------------
--------------------------------------------------------------------------------------------------------------------------------------------------------------------------------------------------------
---o?----------------o-o?------M----o-------oo?----MB---B------B----B--o----?----------------?---------M------------------------------------------M--B----?----M-----------------Mo-------?------M------
------?---?o------oBo-------?----B----o----o---------------------?----?-------o----------------M---?--?-------?-B-----o--E----?B?----M?---M---o-------?---oB--------B--o---B---------B------o--?-----B--
---B-M------------------o-?---BoM--------B---------M---------oM---------------------o?BM--------M-?-----M-?M---o-M-------B--------?-----?-------?M-?o--oB?M---M----------------M---------?--o-o----B-o--
----E-M-------?-B--------B--M----o----o----B-M-----------------?M------------------?----------ooo----o?--------------M--B--M-------?--B---------o----B--------o-------------o--------B----o--?--o-?-----
----B--------?--------M---------o----o---------ooo---B--M-?M--------B-----M--------------o-------M---------BM--M------------------o-o-----M--B-?----Bo----M--B?----------------B-----------o--?--------v
--?-oo?-------------o---M?-B--------------o---------B---oM-------o-------------oo-B-o------M-?-B----------Mo-----------oo-o-----------------------o------M--M---------------B----?---o-----?----MM-----f
--o------B-----?-----?-B----?-----?-----o---B-B-------?-----M---M--?--------o---B--o-------------BM----------?-B-?-?---?o--------------o-----oo?-------?---o--------B----M-?-----------M----B----------f
-B-o--------M--------------o-o---------?--?----MM----o------o--Mo-----------o----B----Bo------B---------M---------?---M--------------o-----Bo-?--oo--M------oM-M------ooM------------BB----M---?o------f
---?M-----B----B------o--M------B-----B--M-M------o--------------oM----?--------------------M---------------B-o----------?-----------------------o-------?-------oM------o-?Mo--------------o----------f
-------B---o?----------------o?M-------oo---M--------BM----?---o-?---------------?M--?--------B-?-?-B----o---B--Mo-----M--------?-oB---oo---o------?o-----------B---o?-----------?-B---Bo----B------BB-f
------------------o---------o-------------------------o----------------------------------------------------------------------------o---------o-o---------------------o---------------------------------f
m--T-------------------------------------Xo-------o------------------E------------o---o----------X--------------------o-------o-----------o--------E--T----oo----------o---------------------------T---X
XXXXXXXX-XXXXXX-X-X-XX-X-XX-XXXX-XXXXXXXXXXXXXXXXXXXXXXXXXXXXXXXXXXXXXXXXXXXXXXXXXXXXXXXXXXXXXX-XXXXXXXXXXXXXXXXXXXX-XXXX-XXXXXXXXXXXXXXXXXXXXXXXXXXXXXXXXXXX-XXXXXXXXXXXXXXXXXXXXXXXXXXXXXXXXXXXXXXXXXX
