--------------------------------------------------------------------------------------------------------------------------------------------------------------------------------------------------------
--------------------------------------------------------------------------------------------------------------------------------------------------------------------------------------------------------
--------------------------------------------------------------------------------------------------------------------------------------------------------------------------------------------------------
-----o--------------------B------B---------??o------?B-M----?----------B-o----o--B--o-?M---?-E-------B-M------M-B----MB--M----B-oB----------------??-----?--?--B-----M----------BM------B--B--------B---
-------------??B--?-------o-o-?------o--?M-------B-------B---?-----??--oB--B----o-B?-B---MM--BM--?----B-M---------o-?--B---B----------B-----o----M--o---------o--?-o--?---o---o--o--------------M-------
--B---------o--o----------------B----M----------o----B-o--?----B-----------------o--M---?---o-------?-------?-o----------M-----BB---o----B-------------?--o-?---o-------------B----B------o---o?----o---
--o------------B--M---B---B---M----B-o----M--M-----M-------------B-----------?-----M--o-------o-?-M-------M--------------o?-------o-o----o--------?-----o-----?---B----------------------------o--BB-B--
---M----------o--------MB---------------M------E-o-----?-?-------o--------------?------------------------------------o--------M---o------B---B-------------MB--o------?M--?-?-------------B-----------Bv
--o--B-?---??-----o-?----o-?M--BBMoB----o---oM-M--B--------B----o---B-B-B-?----?-?----Boo--?-?-o-?--oo-?--B--M----o--o--?---B----------o--------B--o-?-----------?-----------M-----M--M?-B--B--o--B-oM-f
---?------------------B-----------o--B---------------------------?-o--------------B------Bo-B---?---?----?---o----------------MM--E-Bo---------------o---?---o?M----------?---------o-----------o?----Bf
-?B-o-o---?---B-----?--?---------M----?-E-----B-------B-------------o----------B-M------M--------o------------M-------------oB-o--M--?-?---------------M-----B---B-----B------?----M------------B---?--f
--------o---?-----------------?--o-o--oBB---M----M-o-----o------B--M---?--?---B--------------B---?----------------o-?B--B?---------?B---o-------o---?-------o--oo----------M-?-------M--------o----?-M-f
-B-----o-----------BM-M---?-----o-o-?--------?o-M--M-M--?---ooo--------------?-B-?B-----------------?B----oM------M------------M---o---B?---B----M-----?----o---o---M-----------oo----M-B------M----B--f
-----o----------------------o--------------o-----o-------------------------------------------------------------------------o--------------------------------------------------o------------------------f
m-X----o---------------------X---o---------X----------------o--------------------------------------o----------------------o--------------o-----E--------------o-----------------------o---------o----X-X
XXX-XXXXXXXXXXXXXXXXXXXXXXXXXX-XXXX--XXXXXXXXXX-XXXXXXXXXXXXX-XXXXXXX--XXXXXXXXXXXXXXXXXX-XXXXX-XXXXXXXXXX-XXXXXXXXXXXXXXXX-XX-XXXXXXXXXXXXXXXXXXXX-XXXXXXXXXXXXXXXXX-XXXXXXXXXXXXXX-XXXXXXXXXXXXXXXXXXX
