--------------------------------------------------------------------------------------------------------------------------------------------------------------------------------------------------------
--------------------------------------------------------------------------------------------------------------------------------------------------------------------------------------------------------
--------------------------------------------------------------------------------------------------------------------------------------------------------------------------------------------------------
-?-M---B---o?o-o--o-E-?o-----B----MB--oo-----o-E?------------o----o----E----M---T---o----o---M---B---o----o--o----M??-o--o-M---------MB-----BM---------ooo-B----o-M----Bo---------M--?------o??--B--M---
-o--Bo---?M---B-----BBoM-?-M--o----------BM----?-M---E---M--B-o--B-o--?--?--------o--BM----?B----o--oBE--o---o-o----o--------B-M?----------------M---X-ooBM--------oB-o-Bo-----BM-o--o-B--Bo-------Mo-?-
--B-----o-o--oo-----------o--?----M---?----M-------?-----------o--B----o-----?-?----?----oB-----?-------B------Bo-?--Bo--o-----oo---------B--oM--o-----MM--o--?-B------o--M-------------?---M-o------oo-
---o-Mo------o--o-----?o------M----?o--EE--oMoMM--M-B-----M-------o---BBBM--B-o-?---o--B-oooE--o---BB--E-EBo-o-----M-o----B--o----o-----oooE----------?----E--------?----o-?TE-----B-----B--------------
----M--B--E-BMo-M----o--B------?-M-----B-o------------B-------Xo--B-M-o--------------o-o-----B-?-oo---oM-B--?-X------?-?-?-?o-o---------------oMMo---?----B----B--?Mooo------B---o---?--------oM-------v
-----?o----M-o-----B?----BM--M-------o-o--B-------M-----o---------o-----??---o-?-Bo-o-----?-o-o--M--B?----------Mo---------------oBo?oM---o-oB-o--MEB--------T------B-----BB-------o-o-B-----------TMM-f
-B-----------E-B---o-?----oBM----E--B-?----M----?----M--B----B-------oo---------o--B--Mo-M-MM---?-----o-?o-------o-o------M--B-------------?-o-?--oM-?B-?--B-------o---B?--------B--B--o-MMT----B------f
--oB--MBoM--?MMoB-o-----B-----B--------------o--oM----??-M----M-------ooB-oE?M?---------B--o----o-?B--?-----------E-----M---?---E-o---o-------M--?-o-o---B----oBo-?-----------Moo--?-----------M----B-of
--o--B--M-o---------B-?o----------B-----o----o-M-----o----Moo-o-o----o--o-?-o---Bo?------?-------Mo---------o--o----M----oM-------B--M----o------o--o-----------o?-----B---o--oo-o-o-------------------f
----B------------oM-oo-----?T-----------oo--M----o-oB?o--------M---o-MM-----o-?o-o---M---o-M------?Bo-M-Mo--------M-----B---B----oo--o?-?------M---Mo?o-?---E------oMo-o---------M---B-?--oB--B---o-M--f
-o------oX-----------------o-----o----------o-----o--o--------------T-----------o-----------------o------------oo---o-T----o---------o------------------o---T--E------------------o-o-X----o-------o---f
m--T-o-------------T---X---o-o--E----oooX--E--o--o?--Xoo-----o---E-----o----o-T--o--TEX-X--X-X----oo--To----X-oEX-----X--X--T--E-o-E-------B-----oToTE----E-|o-XE--E--To--E----EoM-Xo-Xo----------T-XE-X
XXXXXXXXXXXXXXXXXXXXXXX--XXXXXXXXXXXXXXXXXXXXXXXXXXXXXX---XXXXXXX--XXXXXXXXXXXXXXXXXXXXXXXXXXXXXXXXXXXXXXXXXXXXXXXXXXXXXXXXXXXXXXXX-XXXXXXXXXXXXXXXXXX-X-XXXXXXXXXXXXXXXXXXXXXXXXX-XXXXXXXXXXXXXXXXXXXXX
