--------------------------------------------------------------------------------------------------------------------------------------------------------------------------------------------------------
--------------------------------------------------------------------------------------------------------------------------------------------------------------------------------------------------------
--------------------------------------------------------------------------------------------------------------------------------------------------------------------------------------------------------
-E----M----?------M------o------?---?o---------o?---?---?------?----?--------o--------------o--?M---?----B-----?Mo----B-----------?-----M-------?---oo--------M?-----?----oo?----------------M?-M-o-----
-?-----?------B------?---------B-----M?----M--?----------?------o--?---M-----oB--?---------------M--------------o----M------B------?--o----oM----?--------------------M-?-B--o---?--?--??--Mo-o-----?o--
---B------o------MM-o---?--o------M----Bo-M-M----?o---?-?--?-B------?-----Eo---M------?---------M------M-B?----?-----------o------M-----M-M----------M?-------M--?---M-------?--M-??---o----o--------o--
-----------o?-M-----o----M--B----?----?--------?---?Boo-----o-B--?------B-B--------------o-B--M-----------o?--------o--------------o--?------M-?---------o--??--B---o-----BM--------------?----------o--
-M-------?-------------o---------------?----B-?-----o---M------B-------------------------oB--M-B-?-------M----M?B--o--?-o??------M---?--?--?-----B----o----M---o---oM--?-------?o------oo--B-?--?B-----v
----?-----M-M?M--oM--?----MB---B-----M-----?---M------?------------?---B---M--------ooMoB-------------?-------------------------E---?--------------o?B---o-o-------o-----M--?------?-?M-M-oo--M---M----f
---o-M----------o------Mo?o------------M------B-----B----M--o?------?----??o-?-------------?-M----------?--------MM--B-----B?--M?--------?--o------o-o?--o----o-----B-o------?---------?-------?-------f
-?---o--?--B--------------------?--B-----?-M-----M---------------B------o------M-----B----M-----o-M-o------------------B------?----?--B------------o-B-M--M---o----o----------------??----B-------??-B-f
---B--M---------Mo-?----?---B---------o----------oB----o----------M---------?----o------M--------------------B--------?--------------?o----??--?M------------B-------------o-M?---?---???------?-------f
--------B-----o-------?---o------?--------?------------------?----------------------o-----B---------o-M-M-M-----?---------BoB--------------------o-----B------Bo-MM------M---oo--o------------B----?o?-f
------o-----------------E----------------------------o------------o------o---o--------------------------------------o----o-----------------------------------------------o----o------------------------f
m----------o------------X----o---X-------------E--------------------o-------X-----------------o-----------------------o--------------------------o--------------o-------------E----o----o--o-----------X
XXXXXXXXXXXXXXXXXXXXXXXXXXXXXXXXXXXXXXXXXXXXXXXXXXXXXXXXXXXXXXXXXXXXXXXXXXXXXXXXXXXXXXXXXXXXXXXXXXXXXXXXXXXXXXXXXXXXXXXXXXXXXXXXXXXXXXXXXXXXXXXXXXXXXXXXXXXXXXXXXXXXXXXXXXXXXXXXXXXXXXXXXXXXXXXXXXXXXXXX
