--------------------------------------------------------------------------------------------------------------------------------------------------------------------------------------------------------
--------------------------------------------------------------------------------------------------------------------------------------------------------------------------------------------------------
--------------------------------------------------------------------------------------------------------------------------------------------------------------------------------------------------------
-B?-----o------?-o-M---------ooM----?o?E--?oMMB---Bo----B-----o------E-o--------?-B-?--o---o--?------?-Eo-M--o--oo--EB--E----o-?----?-----?---B-------M-B----oB-o----o----o------------o-E---B--------o-
--o------------o-o?---B---M----oo--o--oM-M----o--------------------Mo-?--o-?-?-o--------BB----o-M----o-BE-o--oo-o--M?-?--B---o---?-----o-o--?------?---o-o--B-o-o-BMo-o--M--o--MMM--M?---B-----Bo-----M-
----?M---------M--o--?---?-B-----M---o-o---M---M--B-E---?-o----??B--------------MoMo--------Mo-------o--B----oo---------B-o-?oooB-?----?M--------M-o-----------MB-----o-o--------o-----o--MMo-----TB-o--
-M--o---------Mo--M---B-B-----o-----?o---M----o-------?--B-oM-?--oM-----M--?---B-BooB-E-B--o------M--M----o-Bo-----ooo-----M----o-o?o-----?o---B?--M--o?--o-oo-------------Bo----o-?-----B---B-E-M-oMMB-
--B-----------o-B--o?------oB--o?--B-o---o----MBo--o-------------oo--o----M-E-B---MM--M-------o-----------B----B?-B--M---oM----------o-----B--?--o--E------M-----MB-o-----o-?-MM-o----M----o---?-----o-v
-M--------?M--MB--o----BME-------------o-----M---?MB------?oB------------?-----ooM----o---?----o-------M--o--M------------o-------------?EMo----M-?-?----?M-o-M-B------MM--B----o-?-E--B-----------?EM-f
-o--o-B-??--??-o--T--Bo--T---M---oo-Mo--?-o---M--------M-M-----B-??-----M-B--?--B--o-o-B------o--E-----oX-----------?-M?--B-o-o------oo--Mo----?-------B----?----------o-B---M--o--------B---o-B-E--B--f
-o--o----o-?---------------------o---B-M--o----B-------oM----?-oo---B------oo------MBE?o-M---B---M-?-----?--oo-?-----?---o---?-Mo-?MB-oo---ooMMoB--Mo---B-o-----M--o--oB----?--??----M-----o-B--?M-----f
-----M----o-o--?--B---B----M-?-E?E-------------------M---M-----o------------TBB-M-o-----------o-------?--o?--B----------o------o-B--o-M--M-oM-----o----------------?-----?----M--------?------------?M-f
-M--M---B----EB-----o?-----o---B-----M-----E-?Bo?B-M---B----B---MM-o---?-----o-?-o---T----------?-E------M--M---o?-o-?--o---o-o---oo--------o-o---M---M-MBo--?--?B--o-o-?-B-oB----?----oo--?----?------f
-o-o----------oo-E-----------o----------o-------------------------o--o-o---o------------o--o-------T----o---o---o------E-o--------------o--------o------------o-o--o---------------o----E---X--o-------f
m-oo-----Xo-ToT----oTE-oX---E---o-T----T-----E------X----oE--------ooT---E-------E-------E------o----B--o-o-----E---EE-X-E-------X-EX----TX--o----T--o--E---o-------T--o-------o------XT--o-X-XT-------X
XXXXXXXXXXXXXXXXXXXXXXXXXXXXXXXXXXXXXXXXXXXXXXXXXXXXXXXXXXXXXXXXXXXXXXXXXXXXXXXXXXXXXXXXXXXXXXXXXXXXXXXXXXXXXXXXXXXXXXXXXXXXXXXXXXXXXXXXXXXXXXXXXXXXXXXXXXXXXXXXXXXXXXXXXXXXXXXXXXXXXXXXXXXXXXXXXXXXXXXX
