--------------------------------------------------------------------------------------------------------------------------------------------------------------------------------------------------------
--------------------------------------------------------------------------------------------------------------------------------------------------------------------------------------------------------
--------------------------------------------------------------------------------------------------------------------------------------------------------------------------------------------------------
-o?-T--o----?Mo-----oo-M---M---------o---M-M?----o---------B--oEo--?oooo?-M-B--o-----?---------------------------M-M-M-?---o---B---B?----B--o-?-B----MM----M--------M?o--T----oooo----o--------B----?---
---M--o--o-?---?-------oBEM--o-----------------o-BB-B--M-------ToE--o--B-----?---MMMo---oM-------B-?-B-E------Bo--o-----o-?--?-o-----M?----o-----MME---?-------------o----o------BM-BB---E--o-----B-----
--M--BB------oo-?-M--?--oB-B-----o----o----Mo-oo----o------B-----M--Bo---------?B--o---o--M-B-------o----------M---o?o-o--o---o-M------BE--o-------?---o------o?o----MM-oo------B--------?-----EE-------
---o---o-BE-M-----o--o---o----o-------?---M--B-o?--?---B-------M-o?-o----B-XE----------E---B---B?-M------M---M--o?------?---M---------?--------o--M-------M-M----o?E-o-----------------oM------B-Eo---M-
----------BM----BE-----M--------BB-------Boo------Eo-----oE-o-X--M-B----------B--MM--oM-?----B-ooB---M-----------------?o?------E----o-BMo---o-----B?--M----------oB-------M-o---------o---B--B--M?----v
-?o---------o----B--------M-o---o-?--------B-o----B----Mo-B----B------------M-------BMo--?---o-o-o--B--?------o-E----B---o---o--M-o-M--------o?--o---B---B-----------B-BME?-?-----B------B?-----M------f
-o-M--E---oo?-----?--?-?-Mo?---?-Moo?M------------oM-TB-o----?-o---?-oMo---o--B--M--o-?-----B?M-----o-----M----BBoo-B-----?B--Bo-------?M-o---o-------oo---M----?--------?-B-B-o?------o---E-B-B---MB?-f
----ME--------M---o-----------o----M----o----B--Mo-oo--o-B------B?----o---M---oB-o----o--B---o-BBB---o-o--oo--o--o----o-B---------E?M-B----M--------M-BEo---M-o-----o--?-----------o-----oM-B-o-M-B-o-of
-----M-----?T-----?----E--------------o-----o-o-o--o--?BB--M-oo---?oo-M---------Mo---E-B-------o-o-o--?oo-o--------M---o-B--------M-o------o--M--EB----MM-?M---M----B--o-----?----?B--?-B----?------o--f
--MoB-?---------o---?o?BM-o---o----oo---o--B--?o--B-------Boo--o--o?--------E--o--M-------M-----o----------M?--B--------?-----------o-?----?-----M--o-Bo-o-----o----o-B-----oo--?---B--?-MT-o-B--E-----f
----o-----------------------o---------o-----o--o---o---To-o-------o-X--------------------T-------T-oX--o----------------o--------o---E-----------------E--T------------------o-------------o---X-----o-f
m---To-----o-E---X------E-o--E----X--Eo---E-E-oX--o----------E-----TX--------X---T--E---TX-E---E-X--X------T------TET-E------------T-X-E-----E----E-----------X-----o--T--X-X----T-----T-ooB-oXX--o-o-oX
XXXXXXXXXXXXXXXXXXXXXXXXXXXXXXXXXXXXXXXXXXXXXXXXXXXXXXXXXXXXXXXXXXXXXXXXXXXXXXXXXXXXXXXXXXXXXXXXXXXXXXXXXXXXXXXXXXXXXXXXXXXXXXXXXXXXXXXXXXXXXXXXXXXXXXXXXXXXXXXXXXXXXXXXXXXXXXXXXXXXXXXXXXXXXXXXXXXXXXXX
