--------------------------------------------------------------------------------------------------------------------------------------------------------------------------------------------------------
--------------------------------------------------------------------------------------------------------------------------------------------------------------------------------------------------------
--------------------------------------------------------------------------------------------------------------------------------------------------------------------------------------------------------
--B-o-------M--E-----o------?---------?-B-------------?----------------M----------B-M--o-------M------?---M--MoB----------?----o----------o------------o-----M-------M---o------B----B----------B---?-o-
---?---M-------?-B-?---?--o---B---------------------?----oB-Bo-----Mo-------------------B--o------B------Bo--oM-?-?-B----------M--------B-------M---------?-?------B--?--------B--------oB----B---------
----M----M--------------?-----------?----M?-----M-----o-------------MMB-----B?---------------M---M---M--o-B-------------------o--?-------o-----o-oB-M----------?----B---?----B----B---------?--o?-----o-
---?--------------M------?-o-?---?----B-o---------?--------?--B--o-?------oM-----M-?----?------o--oo----?-------?--?---o--?---??--oo-MB-??---M----------------?----B-------------------B---M--?---------
-?M----??--?---M-?-?-B--M---o-M---o------------oM---M---o?--------------------------------B----?---------?oo?--------------?-B-------o---------------M--------------B-M-o---------?-M------------------v
---BB----?B---M-o-------o-----------E---?--B-----??--------?-------------M----o-?-------?-----M--------B---o-----------B-o-----?----o?-------?--------------o----?----------?---M--------?-?o-o-o--M-?Bf
----o---o--M-?-----oo---B---?-------M---o----BBB--------B---?-----?M---------?---------M-----M--M-----M----------------------------M-----?B---B------o----o---o------------?-----o--Bo--B---?--?M------f
---------------o--B---ooo----B-------B-------o--B--------------------------o----B--o----MB-----------?--M---B?----B----?---MM-------------o--B-o---o--o----------------o??-o---o-----------------?--B-Bf
--o-----------M-?--?-M------Mo---B-----------o-M-----?---?--?MB---------?-o----?o-----------M----------o-oo----------MMo-?---?--?---o-M-o-------M-o---oB-----------M--Bo----o---M-B----o-------o---o---f
----o--oB---MB---------B----------M------?---?B--------------------B--M?-----M-----o-----oM---B-------------X--M-?-?------o----?-----M----BB--------?-----------------o-------MB----M---M---?---o------f
------------------------E--------------o-------------o-----o-----------o-----------------------------------------o----o----o---------------------------------------------------------------------------f
m-------------------------------------------------------------------------o-------------oE-----o-o-o-----o--------------------------------------------------------------o---------o-----o----------o---X
X-X-XXXXXXXXXXXXXXXXX-XXXXXXXXXXXX-XXXXXXX-XXXXXXX-XXXXXXXXXXXXXXXXXXXXXXXXXXXXXXXXXXXXXX-XXXXX-XXXXXXXXXXXXXXXXXXXXXXXXXXXXX-XXXXXXXX-XXXXXXXXXXXXXXXXXXXXX-XXXX-XXXXXXXXXXXXXXXXXXXXXXXXX-XXXXXXXXXXXX
