--------------------------------------------------------------------------------------------------------------------------------------------------------------------------------------------------------
--------------------------------------------------------------------------------------------------------------------------------------------------------------------------------------------------------
--------------------------------------------------------------------------------------------------------------------------------------------------------------------------------------------------------
--------B?-o-----?-o?--M----B------?----------o--B--o--M------Mo--?---------M--------o------------------------------BE-M------o--?-----------M---------M?-M------o--?----------o-?---B---oB--B----------
---------------?--?M----B-?---B-----M-?------------------------------o-----M-------------B--MB----?-M------?---------?--M------?-----------------?-B----o---------MM-B--B---?-----M-----oB--?------?o---
---B----------------------------------------oB---o-------X--?--------Mo-?---o----?-----?M-----B?-?------oM-o-BB-B--??----?------B------B-o---?-?B---------?--o---B--M--o--B-----o------------M--------M-
------o-B---------o-B-ooB-----B------o-?----?-----oo-??o--------o-----B-------------------------?----------------B----?---M----------o-----------B---o-?--------?----------o--M----------?-M-------M?---
----------------B-----o--?-----?B-o-----------------------B--?---?------oo-?----?-----o-B---------------------o-o--oB----?-o--o-------B---M--------------?---o-B-?---M--M--B---M----o----------B-------v
-o-------?----o---B----B?--------?o-?-----M---?---E----o---?---?B----M-o--B------B--o----------Bo-----------o---M-----?--------------?----------------B---M------------------B-o-B---B-------------o---f
-o--?-o--------------------M--o--------?-?---------------B---o--oo-?---------o-----B-----B-------M-B--B------M-------B-B------------------B?--?---E------?--o-----o--------M-------?o------Mo--M-M-----f
--?--------------?------?--------------o--------B-------B-M--oM-?o-----B-?---B?--------B----o---B-----o---------??----------------?----M-----o-B--?M----?-----????-----o--------------Bo------------o-?f
-B----B-o-------------?------B-----?------Mo-B-o------------------------Bo----o-----------B--B-------M------B-------o-----------B-------------------------BB-----o--------?---------MM---------------M-f
--?-o?--B----o-------?-MB---o-------M-o?-M----o--B-Bo----------B-----?-------Bo----?------------?--M--o?B------?--o-----------o--o--o------?---MB-M---M-------------M------o--??BB-------o-B----?-----Mf
---------------o------------------------------o------------------------------------------------------o----o------------------ooo---X----------o-o------------------o----------------------o---------o--f
m----o------------oo------------o------------oo----------------------o-o-o-----------o-------------------------oo-------X-o--------X-----Xo-----------------o---------------------o--o-X------o--------X
XXXXXXXXXXXXXXXXXXXXXXX-XXXXXXXXXXXXXXXXXXXXX-XXXXXXX-XXXXX-XXXX-XXXXXXXXXXXXXXXXXXXXXXX-XXXXXX---XXXXXXXXXXXXXXXXXXXXXXXXX-XXXXXXXXXXXXXXXXXXXXXX-XXXXXXXXXXXXX-XXXXXXXXXXXXXXXXXXXXXXXXXXXXXXXXX-XXXXX
