--------------------------------------------------------------------------------------------------------------------------------------------------------------------------------------------------------
--------------------------------------------------------------------------------------------------------------------------------------------------------------------------------------------------------
--------------------------------------------------------------------------------------------------------------------------------------------------------------------------------------------------------
-------o?o-o---o?------------------------------------------B-o-o--------o--?---------?----o---------------?-M--o--o----?--MB------------M---M------M?-o---------------?B---?oo----o--o----------o-----B-
-----MMo--o-B--o----?--?---?---M-----o------?-------BM---?M------------B----?---?M-?-------?-------?--M------B-----------B-----o---B-----o---?---M---------M---------?--------B-----o---o-?B-?--?-------
---?--o-MMM---B-B--------o--o-----o---M--M---?M--?-?--------------B------------------o----M----BMM--oB--------M-BBo----M-o--?---------M---o--o-----o--?---B------------------B---------M------?o--------
-B---------B-----?---------M----?---M-----?-------B-M-----------------M--MB-??M-o------------o-----BM---o----B----?---ooo--?---B-----o---B-B-oB?-----?o----?-----M--?-----------------oo-o-----M------E-
-------?-o-----M---B--M---Mo---?--------Bo---------------M---??----------o-----------o---?---M---o---------?--B--Eo------------------M-----o------MM---------B-?--------o--------o?-----?-------B-----?v
------o----B-?-o--oo--------B-B------M-B----M------o--------?-oM--------E?----------Bo-----o------?-?--M--o-?--o-B----------B------o---o----M----o---BB-----?----M-?-----------M-o--BMB----------B-----f
--o----------------o--?---------Mo?-------B?oM-B-B---?-------M--B--o-M--B---?---?o----o--------------------M------?-?-?--------?---?---?-----?o--o-B----?o---o------o---------?-M-------?-----oM-o-----f
-o-----BM-?------?----------E---------o-----------B-----?--B------M------------o-----------oo----B-----M-----------M----------M-B----------M---------oM-------------------?---------o-o-----o----------f
---------?------------------MB-----Bo-------BB-------------o----------------o---M------------M-------?----------------------?o----------o-B--o-----M---B------?---?-?---------oM-?--o------------?-----f
--?--M--------------Mo----o-----------MMo-----------?-o--o---o----M---B---B----?------?----------M??---------Bo------B?Mo--o-o--------------o-M-?----------o-------?---M--------B--o--E?---BB--oo-oB---f
------------o--------o--------------------------------------------o---------------------------------------------------------o--------------o--------------------------o------o----o-------------o-----of
m-------------------o-------------------o----o----------------o-----------------------o------------------X--------o-----------------o---------------------o-o-o----o-E---X--------o------o------o------X
XXXXXXXXXXXXXXXXXXXXXX--XXXXXXXXXXXXXXXXX-XXXXXXXX-XXXXXXXXXXXXXXXX-XXXXXX-XXX--XXXXXXXXXXXXXXXXXXXXXXXXXXXXX-XXXX-XXXXXXXXXXXXXXXXXXXXXXXXXXXXXXXXXXXX-XXXXXXXXXXXXXXXXXX-X-XXXXXXXXXXXXXXXXXXXXXXXXXXX
