--------------------------------------------------------------------------------------------------------------------------------------------------------------------------------------------------------
--------------------------------------------------------------------------------------------------------------------------------------------------------------------------------------------------------
--------------------------------------------------------------------------------------------------------------------------------------------------------------------------------------------------------
------o-E-----------------BMB-oo--M----B-?-B--o-----------o-------------T-oM-----------------???----?----o---?----------B------M-M?--B--Mo--B--?------E--M---oM-----M-Boo-M---?------------------o--oM--
-o-M----B---B--B-o-------------B--------o----B--o----?B---------------------oB------E--E---oM-ooMo----E----o-o----B-?----o-oo---Bo--M-M----o-----------?----------oo-?-----?--oooo--??o-M------o--B-B---
-----B?-o---o-B-B---o---o-B-MM-o-MEB---o------o-----B--?----MX---?---M--?BB--o----?-M-??oMB------o-M-?--E-----o--?--oo--BMMB-B---------?-----o--?-B-??--------?-------B-------oM--o?------------oB------
----B-----M-----o----MM----o--?------??--??E-M---o---M--o----------M--o--------?--oB-----o-B----?-M-o-o--MM-M--------?----o---?--o----o--?--o-----o------M--BB-------------o---------o?------Moo--Bo----
-----M?----?------o-?o----o----E------o--o--Mooo----?----o--?-?o------B-??o-----------B---oo?-oM---------o-B-o-o------------M--B-o----------o--Mo-----B----oo----B-MM--o-----?----B-----M------MB-o----v
-------------o-M-----M---------M-T-------o--------?----E---o--o-B------oo----BoMB-M------Bo--Bo---------B----o-B-----M----o-o-?-?-M--B-B?--?o-------?-o-----BoMo-----?---oo----M-?-------B------o---o-Bf
---B-o----------o---M----B---?M-?-o--E-----o-M?-----o--?---E-----------------o---Mo-oo-------o-oo-------------?o-oE---M----o--o-----?-?---?--M?---oB--o---------?--o----M----M---o------o---M?---M-----f
---o--o-B----o--------------M--B--BMoBo--M?--ooE--o-?------BB?-B--o--?----------EoEB---BoB---M-B----o--o----------M---oB-M-Eo---o---------------M-----TB--B??-?---o------MBB--o-o-?o-BMB--?-o-----M----f
-B--B--?--E-?----?--M---B--Mo-o-M--o---B----M--B-o--------M-o-----------BB--M--?----?o---o--B---o-------o-M---------o-M-----M-o-o??----o-?B----o-M-oo---B---------o----------o--B------------o-----M-o-f
-----o--MM----?-----o-?-oM--------o-----B-M?-----------BM-o-MM---Moo---o-----M?-MM--o--------?-----o----B-------o--M----M---ooo-o--?-------BB----o?o--oB-----BBM--------o-o--o--------?--B-?-M---B--B-of
-o--oo-----o--o-------------o----o------o----o----------o----------------------ooo------o---oo--o----oo--------o---o--------o-o----------o----------------o--------o--------------X---o---T-----------of
mX---o-o--o-----X-Eo-ToE----E---T-o-?---o-o-X-----B---o--o--E--oo-T--EoE--X--T------TX----o---o--o-o-X---o-T-----o--------E-o----Xo-EE--o--X--X-Eo-oTT----oo-ooToo-----X-o--oo-X---B---E-o|-----o-----TX
XXXXXXXXXXXXXXXXXXXXXXXXXXXXXXXXXXXXXXXXXXXXXXXXXXXXXXXXXXXXXXXXXXXXXXXXXXXXXXXXXXXXXXXXXXXXXXXXXXXXXXXXXXXXXXXXXXXXXXXXXXXXXXXXXXXXXXXXXXXXXXXXXXXXXXXXXXXXXXXXXXXXXXXXXXXXXXXXXXXXXXXXXXXXXXXXXXXXXXXX
