--------------------------------------------------------------------------------------------------------------------------------------------------------------------------------------------------------
--------------------------------------------------------------------------------------------------------------------------------------------------------------------------------------------------------
--------------------------------------------------------------------------------------------------------------------------------------------------------------------------------------------------------
----o-M-------?-oo-o---o---?---o-o--o--------o-o?-?------------E---o--?--Mo---?---------------------o--?-?-o--ooo---oM---o-----o--?-Mo--------M--M--o--?---o----o--o--Mo-M--------------------o---------
----o---?-?---E--o-------------o-E----o-----o-----o---o--------B------o------------o-------?-o-------o--B--?--oM---Mo-----------o--E-------------o--o-------?---?----M---o---?--oo------------M-------o-
--------E-----BM---------M-EoM---B--o-oo-----------------Mo--oo----o--M-------------oE---?-o-----o-oMM----ooE---------o----??-o-??EM-o---------o-o--oM-E-----?--oo-ooo-------o------------?--------?-B--
------o-?------o-?M--------?----o-M-o----o--M-oM---?B-----M------oo-M-o--------M-----?--o------M--E-o---o---?---------------E-o--o?o--o---M-----o------M----o-----M-----------o---?-o-----o-o----o------
-oo---?-o------?--o-o---B---Bo----o-E--oo---oB----E---oM---o-----?--o--------o--?-o--o-o---?------Mo---M----o--?---?o----?--?----oo---?-o---------------B--o--------------?---?-----oo-M---ooo----o--?-v
------o-BM-------o--o-E----o---M----?------oo---?-Mo----o-o--o---o--o-------o--oo--?-M------o-----o----oo-o-o--------M----o-o-----o-o-o--oBo-------M--------oM--------o----------o-------------?o------f
------------------o-o-?-o-----oo-----o---oM-o--o--Eo---------o----?---------E---M---o-----o--o-o-----o----M-----------M-------o----o?o-----E-B-----o--o-?-o-------------M-o------------oo?-o---o-?-----f
----------o--------M-----MBE--o--o--------o-------M----------B--------?-----Mo---oB-----?------------------?-?--------o--B--?---B---oo----??--------------Bo------M----------Mo-----?------o-------M---f
-Mo---?--?---?-----o-------?-----o---?-----o------------o-?------M-o--o--oM------M-----------------oo-----Mo?-----Mo--?-o---o---------o-o------o---M--M-----------o--oo------o?---o---o----o-----------f
-o-o-o-----o--o--o-M-----------?---o-------B----o------?-----o---o-M-----------?--M--------M--o-----o------------oo------------?-o?-M----?---------o--oM------Mo-----------o------o----?-----?----Mo---f
--------------o----o-M-----o----------M--?---?---M------?------------------oo-----------o----M---o--------oM--B-----o--?oM-------ooo----?o----o----o----------o------M------------T-M-------------oM--of
m-o----------------oo----T---------------o----o------------oE-----o-o----o----------o---o---------------oo--o-----------oo--------------o----oo--o----------oo-T-E------E----oT---|---o-oo-------o----EX
XXXXXXXXX-XXXX-XXXXXXXXXXXX-XXXXXXXXXXXXXXX-XXXXXXXXXXXXXXXXXXXXXXXXXXXXXXXXXXXXXXXXXXXXXXXXXXXXXXX-XXXX-XXXXXXXXXXXX-XXXX-XXXXXXXXXXXXX-XX-XXXXXXXXXXXXXX-X-XXXXXXXXXXXXXXXXXXXXXXXXX-XXXXXX-XXX-XXXXXX
