--------------------------------------------------------------------------------------------------------------------------------------------------------------------------------------------------------
--------------------------------------------------------------------------------------------------------------------------------------------------------------------------------------------------------
--------------------------------------------------------------------------------------------------------------------------------------------------------------------------------------------------------
-------o?-M--Mo--?--oo-B---M---B----o?--BM-oo---Mo-o------?---o-----ooo---B----oE----?---------?-o----B-B----------M-E-?-M--oo-B------------M-?B------M------------?MMo--o-------o-M--o--------B----?---
-----------?-----------o?---------------o---??----B-BM-M-o----------o--BT------B-M-MBo---B-------Mo----o--o--BBo----oM--o---M?B-E----M?o--------MM-----B--M------?---o----------B-MoBB-----o?--------M--
-oM-B-B------ooB?-M-----o--B-?---B-----M-MB?--oo----------------?---?----M-o----B--o---oB---B------------o-----------o-o--oo--o-M--Bo-oB---M-o----??---o-------oo-B--M-EBo---o-------o-M-o-o---E-B------
--oo--o--?--M-?o-----o--o-?---o---E------o-----M?--?-----------M-M--o-------E?----M--M---------?-oM------------oB-----?-M--------M----?---o----o-------E--M------?-E--M?----M--?----B--oM--o---B--oT----
-------MM----o--B------M---B----B--?-M---B-o------Eo-----o-MB------o?--?----?--?E---B-M-?-o??B-o-------------------MB---o-----M--o---o--oo---o-E-?-----M--------o-oB------?Boo?--M?----M-?MB--B---E--BEv
-?o--------Mo-B--M--o-----?-o-----?o--?-M--B-o-----M---M--B----B--------?---oB-----BoM---?B--o-o-o?--M-?o-----o-E------------o--M-o------ooB--?--oX--o---B-----?----M----E--?--?--------oo-------------f
-o-M---M--BoBM----E--?-?-Mo?-M-?-M-T--o--B---??-------B------B-oo-M--oMoo-?---B--Mo-o---------M-----o-----o-----B-o-B-B--EoB--B---B-E---M-o-B-o--?--o-o?-----E------oB-o-?-?---o?--B---o-----B-B-?-M---f
--------o--------?--?---M--o------------o-------o?--BM-------o--B---o-o-------o-oo---o---BB--o-MoB--oo-----o-----o--oooo?M---------??------Mo--B---BM-B---M--B---------B--?--E-M---oo----oMB--B-----B--f
-?E--M-----?------?B--BE------M-?o-o--o-----ooo-?--o-o?--M----o-o----M----------Mo----------o----o------MMo--Bo-M-o----M-----M----Boo-----Mo-----E-----B--o----M-M-------------o-------?B--------o--o--f
--?---?-------?------ooB?M---oo----oo---o--B--?----?------o-o-----T?-----o-M---o--M--B---B--M------M-------M?-----------?-?---------o-?----BEM-?-MB-o--oB-?---M-----?-B--o--o--??---MM---?--o?-T-------f
-----------------------------o--------------o--o---o----o-o---------X---E----E------T-----------o--o--------------------o------E-o---------------------E------o---o----------o-------------o---X-----o-f
m--TT----T-o-E---o--------o--E-------EoEE-T---o--Eo----o-E---T--o--TX---T---XXXXT---X--TT-------------T----oT----T----X-T-----------Eo------------------------------o---X-X-XT-------T-T-oXo?ooX--E----X
XXXXXXXXXXXXXXXXXXXXXXXXXXXXXXXXXXXXXXXXXXXXXXXXXXXXXXXXXXXXXXXXXXXXXXXXXXXXXXXXXXXXXXXXXXXXXXXXXXXXXXXXXXXXXXXXXXXXXXXXXXXXXXXXXXXXXXXXXXXXXXXXXXXXXXXXXXXXXXXXXXXXXXXXXXXXXXXXXXXXXXXXXXXXXXXXXXXXXXXX
