--------------------------------------------------------------------------------------------------------------------------------------------------------------------------------------------------------
--------------------------------------------------------------------------------------------------------------------------------------------------------------------------------------------------------
--------------------------------------------------------------------------------------------------------------------------------------------------------------------------------------------------------
----M-?---o-M------B----M----------?-----------------?-?----M--------?--o--MM-?---M-?M-B----o-----?-------B?M------M-----------o----o---?----M-B----------------------------?---BM----oBo-?-B-----------
----o---?-M-------B-------B--B--o-----------------?---------------o----B-MB--B-----o-------------------------o?---?-----B--------o-----B-B-o-----B-------------B-------BM------------------B------------
--o--B---?-?---------------B?------o-----M-B-----M-------o--Bo--------?-?------M----------B---?----------B----o?---?-o------B--?----?---M-----o------M----------oMo-?---------------??------------------
---M--M-------------B---o----------o?-------M----------?------B--o---?-----B-------o-MM----o----o--?--MB-------------M----B----------------?----------o--o--o??----o----M-B--B--------------------------
-------o-Bo--MoM------?o-M----o-o-M---oo-----M-----?--M--------BMo--o---------B---?------o-----------o--------------------oM----------------------B----ooMo-B------?-------------M--?-----?-M----------v
----------o---------?-----?--------?o--B---M------B--?---?o------M------?------?-------------------------------B?-B-----o----------------M-----------o?--------M?-----M-?------------M---o-E-M---------f
-----------------B------------------M-----M--oM--------o----?--------------B---------oM----?M-M-------------M--------B---M------------B----Bo------------B---------o-------?--o----o--?----?---o-----o-f
-----------------o----oo---------??----o----------------o--M----------o--M?--?-o----oo------------o-------M?-------M--?------oX--------------Bo---?M--o---------?-------o-?---M--------o-?--B-B--------f
--M---Xo---------?---??M---------------M-B-----------B----o--M-o-o----o--------E-------------M--?-------------M------------o----?-----------------o----M--M-----------M----BB------M--?---------M---M-Mf
-B-M------?------o-M-----------------------------M-----o-----------M---------o-B------?-----o--o-Bo-M-o-MM-----------o------?----oBo-o------------o--------oo-o?o-----------oM---oBoM----?------------of
--------oo-----o--------o--o-------o---o----------------o-----------o-----------------o--------o---o-----o------o------------o----------------------------------------------------------------o--------f
m-----------------------------o-----o----T------o-------X--------o-------oE-------X---------------o--o-----------E----------o----------o-----o-----oo--------o-----------o-----------------------------X
XXXXXXXXXXXXXXXXXXXXXX-XXXXXXXXXXXXXXXXXXXXXXXXXXXXXXXXXXXXXXXXXXXX-XXXXXXXXXXXXXXXXXXXXXXXXXX-XXXXXXXXXXXXXXXXXXXXXX-XXXXXXXXXXXXXXXXXXXXXXXXXXXXXXXXXXXXXXXXXXXXXXXXXXXXXX-XXXXXXXXXX-XXXXXXXXXXXXX-XX
