--------------------------------------------------------------------------------------------------------------------------------------------------------------------------------------------------------
--------------------------------------------------------------------------------------------------------------------------------------------------------------------------------------------------------
--------------------------------------------------------------------------------------------------------------------------------------------------------------------------------------------------------
--MB---o-B--MB---B--oE------o-o-oo-------?---ooo--oMo-o---?----------B-B??-Eo---B----o-o-o---B-----------o----oM----?---?------B-----?--?----??----o-----o------o-o-M-oB---oo---M--------?B-M-MM---?M---
-------o?o-----B-o---B----?-?-B--o-E-o-oB----o-----------o--o-----B-o-----E--oBEoM-BM-o---M----?-----M----M--o----o-------------o?-B-o-------o-oB?-M--o-----------M---Mo--oM------B-----M-oB-o------o??-
--B--o--oX--BM?o--B-M-----------------?Mo------------B--M-------o---M-----?-o---B-----B----BME---E------o--?-T-B-B--?-ooB?------o-----B---o---Mo----o------M---?----M--B-?------B--o---B-o--o-MM---B----
-----MB-o-B---------o-------oE-?------o-MB-----------o-o-M-MM---?---o?---?-----?--o----------MT--M-M--M---------?--M-o-E---?-B---?---E----oM--o--o---o----oo---------?----B----?--M--MMo---Mo-oo-?--oE--
---------?-ME----MB--B---M-----o----B-?---Bo-?E------Eoo-oo---M-o--oooo-M-------Boo-?-M--M----X-M----?--o--o--oo-M--B--??----oo--oo-M?---?--BM-------M--M-----B--o-?-----oo---B-o----o---?--o-------o--v
---oM--M----M?--B-o---?--------------Mo--M-o---oB-M??MM-o-EE-------o-B-B-oM?------M-o-oo---M-------o----?---T-------o------?-Bo?-oo------o?--oM--o--?--M---B-?-----o-----------B--M-----------Bo-o----?f
-B-B-B-------o----M----Moo-o----?------B-----------o--o---?M------------oo------o--o---o---o---------o--o-o----------E---?M---?--o---o--?-----oo--?-----M-M-------M-ET---o?B?-------Mo----?------?-oB--f
-----o--o--M-o-E?---------o-B-----MB-----oo----oB-Bo---o-o-o-o---o----B--B--?-o?--o-?-------M---B---o-----------M----Bo?-----M---o-----M-----MoooB----B----?-??M-M-?X-----o--?---------M--o-o---Bo---o-f
-E-B----E---ooB?----oo-------o-?B-------B----------------------?B----o-M--------------Mo?-?---oB-o-------o--M-----M-?---------M-B-o--M-oooo--------o-o---??--o-----o--o---M-Mo--E---Mo-----?------M----f
-B----o-?--------B---M-o------o---o---------------B----B-o-o---------Mo---E-?-?--B-----o-------o-M-?--M-------o-----o-------B--?--MMB---o---E-M-M--?--B------o-oM---o----M-M--BE?B-B-----------MBB-----f
-o-------oo-------------------------o------o-------oo-----o---o-----------------------------o--oo-------------o---------------------------o------o---------ooE-o---------o-----T-----------o-----------f
mE---T-o---E-o----TX--o-T-------------E---oE--------EE-----E-ETT--ToX--X---o--o-T-EoTEo---------X-E---X---E----To---X-o------o-o---o--T-E---oE---o-----o-E------oo?-----o-o----X---X--T----X----o-TT---X
XXXXXXXXXXXXXXXXXXXXXXXXXXXXXXXXXXXXXXXXXXXXXXXXXXXXXXXXXXXXXXXXXXXXXXXXXXXXXXXXXXXXXXXXXXXXXXXXXXXXXXXXXXXXXXXXXXXXXXXXXXXXXXXXXXXXXXXXXXXXXXXXXXXXXXXXXXXXXXXXXXXXXXXXXXXXXXXXXXXXXXXXXXXXXXXXXXXXXXXX
