--------------------------------------------------------------------------------------------------------------------------------------------------------------------------------------------------------
--------------------------------------------------------------------------------------------------------------------------------------------------------------------------------------------------------
--------------------------------------------------------------------------------------------------------------------------------------------------------------------------------------------------------
--E-----o-------E---?-M-----Mo-T--E--B-X-E-----E-T-?-o--T-E---oM-M--oE?---T--o---E?E-B-oBo----oE-oT-ME----E-o-----E-o-o-o------B----Bo-To---T--E-o-o--X-M--o-?-o-Bo-oM----------M--o-?--Xo----?M----M---
---B-?-----E-B--M-o-ooo---------B-----B--T---MEM-------o----o-E-E-?--?---M--?B---M-------EoEE?-B--|-------------EEM----o-?oEME--E-?----------o-?o--B---o-------E----To-------oMX--E--oB-Xo--T---o--o----
----------o---------T---BB-o--?------T-M--o-M---X----?-o-o---B-oMoo---M---Bo-o-T-o--T--T-----o--?--o---------o--------o--oM-o-o-BB-------o-?o?--o--------?---M-MBo-M--?-BB-E------M--o------|---X--B----
------M------?M-?-----MX---------T-EoX---o-Bo-M--T-------??-----------oo-X--o------B---Xo-E------E----?---------oBo--TE--o-T----o----o--o-Bo-o-oXo-o---o---o--o---XoM-o----M-M-------o--To-o------o--o--
-o-------------Bo-E?o-o-oM?-?-o?-|------o----o--E--o---M-o-o---o-?-X----B-----o-M-To?E---oM-T?--M-----o--?o----Too---|---o-|-o--X-o-?o---------oXEEE--o--B-o--?--o--oBEX-BE---X-To-E---B-M---Bo?---o---v
---E--E--o-o---o------o----o--------o--B------Mo-E-E-E--o--E-M----E--E--oo-----B-E------X?-?-o---------E-o---B--Mo----B------?---o---o--M-o----E----o-X-o---B--o-M-E--M----M-o--|o-M---oMo--o-----T----f
-------o---oBo--M-------------B--M?o--o---TMBEo-B-BB-?-------oM---M-?--T-E----T-?--?--?E---ooTM-----B-----?---?--------?----?o---o-B--T--M--?---B?--?M--T-E?--M--------Mo---oToM--------o--oE----B-----f
-------E---M-T---o---?---oB-oMo----o-----T|--?-E-B-----oB?oo---E-M-o---|M---B---o-B-----E--o------ooo--T-MoBoMo---MMT----o-T---M-o-o--|---MTo-EM---o---o-o------oT-BoE-o-o-------?-E--?-E-------------Mf
-T--o-o---E------ooE-o----o--oE---?---B-o-----M-o-------oo-M---------B?---B---E---o-o------E-o?M-EE-----T--o-------o--B-EE--XB--E--------B-|-B-o---E-E--E--?M-----------?--EXEEo---T----M---BE--o-----of
-------T-----E--ooo-T-E---B--o--o-o-E-----o----oTB---T---M-----MM----o-o--oB-------o---EBTo----o--?--M---------oT---------M---E---?o---o-----------T--BT----o----E-B---T-EoM-B-?--T--E---T-----T--?-o-Tf
-o--T--X-----------------ooo--------T----T-----o---o--o-o-oE-X--o---------o------------T----E----T--T-----E---oX|--o------o-----T-o-----------E--o----o-X----oE-E---------o---o-----X----------|o-----Xf
m-----TXE----oX----oTo----E-X-X-o-?-X--M-|XT-E-o-B---TB--o-X-XT---E-o-o-M-?---oE-oTTo--|EEEo--M-BXX-|----oTT--TX---E-XE--oToo-Xo|E-T-TE-X---EB--oE---------XT-T-X--o-E-o-------X-X-TXT--oo-E-ooX--T---XX
XXXX-XXXXXX-XXXXXXXXXXXX--XXXXXXXXX--XXXXXXXXXXXXXXXXXXXXXXX-XXXXXXXXX-XXXXXXXXXXXXXXXXXXXXXXXXXXXXXXXXXX-XXXXXXXXXXXXXXXXXXXXX-XXXXXXXXXXXXX-XXXXX-XXXXXXXXXXXXXX--XXXXXX-XXXXXXXXXXXXXXXXXXXXXXXX-XXXX
