--------------------------------------------------------------------------------------------------------------------------------------------------------------------------------------------------------
--------------------------------------------------------------------------------------------------------------------------------------------------------------------------------------------------------
--------------------------------------------------------------------------------------------------------------------------------------------------------------------------------------------------------
---o---E---TMX------o-----M-o-----To-E-----E---o----?-M------o------E---o--T?------Bo-Xo-?----BE??----------?--M----o--E??----o--o--B?-?-o?--o-----T-------B--E----E-M------X-E----Mo----?--o----M-?-oT-
--o-----o--X---?T---oEB-----oMBTE------?oEo-----o---o--T-------M----?-?----|-----oo-?o-?----------M--?M-E--T-E-oo-T----------M-----------T---o----T---B----oo-B---?----o-X-TX-M-----E--M----------E-----
-E------?---oo----M---ooB--oE-o-?----o-oTTo----o-Bo-------o-o-B-B?--o-----?-M--?----o-o-EE----M-oo-----T-----??--B----o--?--X-B--B-E---?--M--B----|M----------o---o--X-M---XX--------?--------MM-X------
---X--------E-B-o-o-B--------oE-o-?---E------?-o-o-------o---?----?---?---o------o-----M-M-?-T--T-o----|EE-----oooT-BMB---?--------B-----?o--oB?-----?------------E----o?E---o---EX-Mo-BE---ooo-------o-
--B-o-----E-T-oT-TEoo?T---T----BE--o--?--?--?----------------oBB-o-EE----M-T--B-oo?--ETo------E---?---M--BB----E-------------?-??-o-M---o---EE-----M--o-o---------------o-----E---XTo-B--B--o-o-E--?-M-v
--ooM-------|?---------M--|------B--B--o-o--------E-----?---o--o----T------|--o----E-------------B-B---o-oo---M---?--?-B---?--Eoooo?o-o-oT---T-o--Bo-o-------M------E?--E-o-M--B-M----o------M----o-?o-f
---Bo---o----o----??---oEB--B--?-------B----T---?B-M--EX-----T-T--BT-X-M-----M---BT-E-MM-XBo--M---Xo-?------?-----o--o---E-oo----?------------o-------o-M---T----------E--o-------ME-oE---o------o-o--of
----o--BE--B--oM--o------oE-o--o-------o-------oooToM------T----BMo----o-M----?-Bo--------------E-X-----M-B-ooEM?-B----T---E--M-M--E-----E--E--o------EXoo-?-oE-o-E-M--B--o---?-----ToTEM-------?------f
---TE--o---o?---------T-----?T-M--EoX-----------E-Xo-E---E---BTM-oB-o-?-?--M----o-oMT--X---M?---------?------B----o---X---o--E---E-----o-----o------o-----?oo--oo-T--M-o----Xoo--B---o-----oTT--o-o---Bf
-E----o-------E-X----o--------o--E-?------T-------X-B?E---E--o--M-o--o-E--T---MME?Eo--o--oB-o-----E?--oo-------E-------o-B---M-o-----B?---o--o-------o-o-EoEoB-----M-----oX?----T--X-o----M--|Eo----o--f
----------------------------X--o--Xo------|--------T---oo---------------o-----oo------E---o---------T-o-E-------X-o----------oEEE-T-o-------------E--o-EE-o---------o---T-X-------T----TX-o----oEo--E--f
m-EooX--------------T-------XB----X-o-E-EM-MEET--E-|o----Booo-o-o-o-o---E-----EX--TToETE-o----------|-X----o---o---T----E------TXo|--EX-TB-X---?E---o-o-------T--o--X-----X---TT--|E---XX---E----XE---MX
XXXXXXXXXXXXXXXXXXXXXXXXXXXXXXXXXXXXXXXXXXXXXXXXXXXXXXXXXXXXXXXXXXXXXXXXXXXXXXXXXXXXXXXXXXXXXXXXXXXXXX-X-XXXXXXXXXX-XXXXXXXXXXXXXXXXXXXXXXXX-XXXXXXX--XXXXXXXXXXXXXXXXXXXXXXXXXXXXXXXXXXXXXXXXXXXXXX-XXX
