--------------------------------------------------------------------------------------------------------------------------------------------------------------------------------------------------------
--------------------------------------------------------------------------------------------------------------------------------------------------------------------------------------------------------
--------------------------------------------------------------------------------------------------------------------------------------------------------------------------------------------------------
-o-----Bo-----o-------------?-o----M-----?B-----------oo------------oBM--B----------M--B--M---?--------o-----------B-------------------------?----E-o-o------B?--------E--------M---B----M-----oo-------
-M---------?-Mo-------o?--B---------M-B-?----?-B??-----------M-?--------------------oo-----?---B---?M?--?o-o------?---BB--?-o?B-----?M-----??----?M----?-o---------?M--?-----?-M--------------BB--------
-----?---B----------M----B-----B---o---------------?-----B------------------?-?--Bo---B------Bo--------------?---------o---M-----------?--B-o--M------B--o------------------B-----o-------M-------------
--------------------------?-?-B---M--B---?---o----M---------------o-B--Mo-?----M-------o?B-??-o-M-?M-EM------------------------B----B-B-o-----E-?-?M--o?-----?------o?M---?-oo--?------?----------------
----o-?-?-----B-?M------M------------o-----o------------B-?----------------M-?-----M--------o--------?-o?--?----?-----------------M----B---?--M-----------B------MM------o-BooM------o?-------B?--Bo---v
----?--M-----------o-oMB--B-B----------?------M---M?--------------------?o-----?------Mo----?---------------?-?-o---?B--B----M------o?----M-?----------------------B-M--------o----------?B------B-----f
------------------?-B------B------?--M--B--B-o-----------------B----o-----------?-?-----B-----?---M----------?-?o---------?---M--M----B-B-----BM----?---?-----M-o--------oM--MB--Mo------o-B-----------f
---M----o-B-------o---X---M--M---?--------B--B----------?-------B--------M---------?------------Bo--M--B------------o-M-M---M---?----M---?-----------------------MB?M--?----o------M---?---------?-----f
-----M-------B------?------------o?------------?-B?--?---MM??--------------------M----?----?---o----------------BM?------B--------Mo--M?----------Bo?-?--M--?----o----------------M-?M?-?---E--B?--?---f
---B--B----------------o-------M?----------------------oB--o-?--------?----?--M-----o--?--------B---Mo-----E--o?-----B?-----Bo--B--o--------B---o--?-M---o----E--------------M---M----o-----?M--o?--?--f
-----------------o-----------------------------------------E------------------------------------------------o------------------o--------o----------------o-----------------------o--------------o------f
m---------------o------o--------------------------------E------------------------o-------E--------o-------------------------------X--------------------------------------------------------------------X
XXXXXXXXXXXXXXXXXXXXXXXXXXXXXXXXXXXXXXXXXXXXXXXXXXXXXXXXXXXXXXXXXXXXXXXXXXXXXXXXXXXXXXXXXXXXXXXXXXXXXXXXXXXXXXXXXXXXXXXXXXXXXXXXXXXXXXXXXXXXXXXXXXXXXXXXXXXXXXXXXXXXXXXXXXXXXXXXXXXXXXXXXXXXXXXXXXXXXXXX
