--------------------------------------------------------------------------------------------------------------------------------------------------------------------------------------------------------
--------------------------------------------------------------------------------------------------------------------------------------------------------------------------------------------------------
--------------------------------------------------------------------------------------------------------------------------------------------------------------------------------------------------------
---oo--o-oE----o----oMM---B--o---o-Eo?oE-EE--?EM--E--B----E--BB-MX--MB----?T-o-B--M-TE-E-BBo--E---B--X-T-oE--?EBB-M--B-M----o-----Eo--o---B------o--EM----o-?-B---B------X------------o-E-----BB--E-----
-o-X-T---o------oE---o--------o----------MB----o----M--o--??-o--o--------o-------------M-o----BM?--X---------o--o--M?o---?T-EB?---B--o?----E----BT-M------E-------o--M-M----o-?----oo----?---B-o--B---T-
------B--BTB-o-B-M---B--TBo-T------B-TT----?--X-oX-oo----?----Bo--TB---BX---Mo-BE--------E-?------o----E--o---o-T-Boo--------o--E-oEE-o-o-oM-------o?T-o-----oE--o---------o---X-B------------MT-B------
--o----MM---oE-o-----o-------M---E------?----------o------M----B----oB----B----oXE-T--M-E--o----o---Bo?----EB---|------o---To--B-----o------B---B--o-Xo-o-o---?-o------E-o--E--------T--T---B---B----M--
---M------T----BoE-------?E---BTX--E-Mo-----BX-?--o?B---Mo---B-o-BT-T----Eo-----X-----o-----EM---o--------M--E------M--------T-o-----oMM-T--o---oT--o-o-?-E?Mo-----o--B-oM-MT--B--------XE-T--M----o-o-v
-M-o-T---o--------MMT--T-----?-------------E---o----oo-o-------oEo---?o-----------B--M-B----Bo---o-E--------T-MM---?------BE-|--M-Mo--o----o------B----oo--o-?--------oo-o--------oB-?----E---o--------f
-oXo----M-BE-E----oo-M---o---o--o---o-B-----o--o--o-B-----EB---T----B-X--o---o--BBo---To------o------o?----?|-o-o----o--o-o-M-M-----------MXo---To-----E---------E--oo-E--E---BE--oo--o---T-----?o-?--Bf
----BE---oo?--o---E-M---M---------B---------------M-oo--o--o----T--?o--?o----E-oo-------o---oB?BB-T--Eo--E-----E--TMoE------o-o-----o---------o-|B-T----E-----BBEX---E-----E--o------M--X---E-B?------of
----o---o----T-oT---oo?-o----oo--B----------------o---X----ooM----ooo-E-E--?-X----E-To--o--Eo-o---------X?------M?-o----------?--?---?T--T-----?----------M-----T-----------o----E-B--EM-----o---?-oM--f
-E-?----E-----o---?oX-o-----B-BM--oM-E--BX---M---o-o---oo-TB---M-----E------B-T-X--o--oT----------?--ME-X-----MM--oB--------M--Mo--Mo-X---?-o----------o-?---------oE--X-M-M-E-Mo---oo--?---T------?o-Xf
---o----X---------------o--o--o-o------------o---o-----E--X-T-----EE----T----------oo----------o-T-------X----------o-o------E------o-----oE------T----EX----------------------o--Eo---o-------T-------f
m-X--E-TXoX?E------------o-X--o-T-E------TTX---MT-o-E--T-oX-Xoo?T-XX--E-|Xo-X-E-To-oE-o--T----Eo-X-------X-oEXT---EE--EE-o------E-o-E--E--T-o--X--X-----X---------To?E-T----BT-X-o-ToEo---o-oo-|M?--ETTX
XXXXXXXXXXXXXXXXXXXXXXXXXXXXXXXXXXXXXXXXX-XXXXXXXXX-XXXXXXXXXX-XXXXXXXXXXXXXXXXXXXXXX-XX-XXXXX-XXXXXXXX-XXXXXXXXXXXXXXXXXXXXXXXXXXXXXXXXXXXX-XXXXXXXXXXXXXXXXXXXXXXXXXXXXXXXXXXX-XX-XXXXXXX-XXXXXXXXXXXX
