--------------------------------------------------------------------------------------------------------------------------------------------------------------------------------------------------------
--------------------------------------------------------------------------------------------------------------------------------------------------------------------------------------------------------
--------------------------------------------------------------------------------------------------------------------------------------------------------------------------------------------------------
--o---------------M-?--o-----BM--------------------B----o--?---------?----------o----??---oo----M----M--?M-o-----------o-B--o-----B---?------Bo--------o---------------------M-Bo-o------M--?-----o-----
-o?--Mo---B-o------B-o--------------------M----?--------------------------------B-?----------o---M----?----M?--?-o---B-o--------oM--o------o-----o-----------------------------------o---------B------M-
----?----?-------o------------Bo--?----o?-----?---B---------?--?-------------------o--MB---o-M?---M-?---?--o-----------M----?--?o--o--?-B---?-----------?-------o-----o-B----------B--------------?--o--
-------------B--oooM------B--M------o--M-------o---B-E-o-----M---B--------M--B------------------B-----?----------oo-----------?------------------Bo-------M------o-??----o--B?--B-----------M-----------
--------M------?-------?---------B--?-----------B-o--?M----------------?---------------------o---M-o---M-?--o--M--B----B--------B---------------M-oM----------?--?M-------?---------?--B---------------v
--B-------M--------------o----?------B-o--M-o--------o----MM----o---?-------B-----?-o------------o---B----o------o--------------------B----------o---?---B----oB------?--------------------?-----?--?--f
----?------B-----M--------?----oo--?------------------o--------?--B----B-------o--------?-----------------o-o---B---------?-B-------?---------------------B----------B------------B------?Boo----------f
---?--B-----------M------------------M----o-----------oB--o--------o------o-----o-----?----M----M---------B-B----o--B--M----o--B-B----M----B----M---------------M--?----------------B-o----?-----------f
-----?--M---B-o--------?----?B--------------?-?-B----B--o-------M---------B------M-------------------MB----------------o-----oM-M----M--o?B-----o--o---?-------B-----?-----------B?----------?----M---of
-------------------------?------o---------M-------MB----?------?-------o-----------oM---------?--o-------------o-M-------o-------------------o----?-----------o--?------B---------------o-M---------?--f
----------------------o-------------o--------------------------------------------------o------------------------------o------------------------------------------o----o--------------------------------f
m-----------Xo--------------oo--o----------TT--------------------------o-----------E------E-------------o---------------------------------------------o---------------T-------------------------------TX
XXXXXXXXXXXXXXXXXXXXXXX-XXXXXXXXX-XXXX-XXXXXXXXXXXXXXXXXXXXXX-XXXX-XXXXXXXXXXXXXXXXXXXXXXXXXXXXXXXXXXXXXXXXXX-XXXXXXXXXXXXXXXXXXXXXXXXXXXXXXXXXXXXXXXXXX-XXXXXXXXXXXXXXXX-XXXXXXXXXXXXX-XXXXXXXXXXXXXXXX
