--------------------------------------------------------------------------------------------------------------------------------------------------------------------------------------------------------
--------------------------------------------------------------------------------------------------------------------------------------------------------------------------------------------------------
--------------------------------------------------------------------------------------------------------------------------------------------------------------------------------------------------------
---o------MM--o-M-oB----B?---EBB?---------------B---o-----oBo---o-----?-o------oo-?B?-o?M----B-o----------oo?-oo------oB-E-o-o-T-B---B---o---o-oo--B--oo--o---M----?-M--o-M-M--------?M-o--BB------B-?--
-----EM-----ME-o-Mo-o-------MM---B------B--M----o-o-------Bo-?----?---oBoME--B--------------B---o-o------?----B-?--o-ooE-M-o-oo--------B-o--------M-?----o----o--o-----BB--B--T---M-M------o--------?o?-
--oo?--o-----Boo-------------o----E--MMB------X---o----o?--o--o-----------Bo-o-o-T---------------B-----?---B-----B-----B-oB-M-oM--?---------B-MM----o-----M---------------------o-----------------------
--M--B----XM--?BMM--------M--M--M--M-o-oM--o---o------BB----X-oBB--oM---?-o----?------o---B----o----------o-M-------?-EEo------o-M----MMo------------M-ToM----B--??-B--o---o--o-M-------?-----------Mo--
-o---o---?--oo------o-?oo-o--ooo------M?--?-----o?---E--o-BB--M--B?----Bo-?--?---MM---o-----?-B--?--M------B--------o-?M--Mo-o---oE--B--B-------o-?-----E--------oo-o--?M-M--?o---------oB-M-BME---o---v
--M--o---o-M------o-??-BB--Mo-oM------oE?---o-M--o------oB-o----Mo-B-M?----M--oo----M---?B--------MBE-o-----B---M-----oo-T-----o?-??---?-------M-----o-MB-M-oB----Mo-o----o--o-o-?---E?--oB----M-E--M--f
--o-o-----o--------?----o--------M-M---B--B---------?-oo---oo-------M-----o---B-------B----o---oBB----o---o-E-----MM-Mo--|M---oE-----B----------B-o-o------o-o---B---o--o--o--oo-o----------oo?-----oo-f
--------?-?--o-B-------o-BM----------M-------?--------o-oBo--E-?-BE---EB-?---o---o-B-----??--o---E-----?o--??-B-?---Bo?-------o?M-M---?-----B------T----oM--B-?-o-M-----------o?--B---B--?----oo-B-----f
--o-----Eo-??------o-------M-o?--?o-B-------E-----o-o---M---M?-o--X--oM------o------?-----oE?-?-?M---M--B?----o-oE--ooo--o---E-o---?B-oE-------?--------B--------o--o---o----B------E---------?-?E-M-M-f
-oE?----B-------------o--BB-?---o--M-E--E?----M----B-M--------M-o-X--o----------M--o-o------o--o----Mo-------o---M--?-?-?-M--?-BB-----?--o-------------E--?M---------B------o--oM-o-M-o---M--B---?B-E-?f
-----------------?-?---M-o----------oM--M---M-o---------o-?--X-ooM-?----------BM-----------------------o---o----o-B?---o--------o-E-----M----?--?B---o-------?o-----?-?MM------o----E----M---E----o-TM-f
mT--o----o---o----oE----T---------o-o-----X-o------T-TT--E-EXXo--------X-------oTT-------o-Xo---o-o--E--T----EX--T-oo-oTo---To-Xo-XX---o---------------?--------oX----E---oT-o-X-X-XX-oT-EoE-X--o-T-X-oX
XXXXXX-X-XXXXXXXX-X-XXXXXXXXXXXXXXXXXXXXXXXXXXXXXXXXXXXXXXX-XXXXXXXXXXXXXXXXXXXXXXXXXXXXXXXXXXXXXX-XXXXXXXXXX-XXXXXXXXXXXXXXXXXXXXXX-XXXXXXXXXXXXXXXXXXXXXXXXXXXXXX-XXXX-XXXX-XXX-XXXXXXXXXXXXXXXXXXXXXX
