--------------------------------------------------------------------------------------------------------------------------------------------------------------------------------------------------------
--------------------------------------------------------------------------------------------------------------------------------------------------------------------------------------------------------
--------------------------------------------------------------------------------------------------------------------------------------------------------------------------------------------------------
---B-M--?----?----oX--o--B-o--BM-M-o----?--o?--?-?--Mo-o---------o------BB-?-----M----ooo-BB---oM--M--o--------M-----?---------o-----?-------o--o-M--o---M-M-?---------B--o---------X--------M-o----B---
-o---o---------o-o--o-----?-----E------B-?-B-----o-Mo-------X--o-------o------MEo------T-E--??MB---o-?-M-o?M------o--o-----B---?-B--o--oo---ooBo-Eo-?-M?--?-E--?---------o?-o------------B-----ME--M-?--
-o-M-----o----ooMo-o?--------oB-?--M-----oM-E-oo--M--M---?----M--o?MM---B-M-B--?o-o--------------MB-----o-o-o---o----?o-MM--?---B-?--M----------o?o-o----o----M-----E-------o-o-oo----E-o--?---oB?B--o--
--o--oB---?M----------o?----o-----o---B--o---o-------E----o--o----o-------o-----o--?--??----MM--M-----o-o-o-Bo----o----Eo-o--M-----o--To-o----o?M---B?----o-----?------ooo--oMo---?-------?--M-o---o--o-
-M-Mo?--M------B--M--oM---?-Mo--M-Mo------MM------E----?-------o-oo----Bo-?----o--o---o--------Mo--M-B-o---E---?--BM-----------M--M?E--o-M------o--?-------o-----?-----M?M-o--B------o?-?M-?-----o-M---v
----o--------o---M-o-------------Mo--o-o--oo-----oM--------?-------?---------o----oo?-o----?B-?-M-oo?-MB?----B------------------?---B-oBo--B---?--MoM-----o-----B-------E------MBM-?----o-oo?-?---B-o-Mf
--o-?o---o--?------o-----?----o-o-------?--M--E----o---------B----?------o---B----Mo----M-?----M----o-E---oX-----?-------o--------oE-----o---o---oE----B--?------?--?---Bo--Mo----M---?------------?-o-f
---Mo---oo----o--B---Eo-B----B--E-----?ME-o--o----o--?oB-B--o---?oo-?--X?oo------oo----o-o-M--?--M---??--?---o--o-?-E-o-M---------------oo----oB------E--o------Eo-M--------o---------E-o---o-------Mo-f
-?----?B----oo-----??M-o---BB---M-o------o--M-MM--?-Bo------ooBo--MM--------B---??---?--M----E--B--Mo---M----------?----o---?----oo-M-B------B----------------?-M-----oB?--B--B-o-o---B-B--o---o-----B-f
--------o----o-o-E-o----B----M-E----?-MT----------oM------?---------?-?---o--?--o---o------?--------o-o-E-------?o-o--?--o-M-o---------Mo-BM--?-o--o------?-------o?-oo----------oBBo-----?B----o-----of
-MMo-?--o--oo----M---o---------?-EM-----oo---?-?----X-----ooM-?--MB---EM---??oo---o--------o-oooo?--------B-o-?----oB----o----o-----o--o----?---------??oo---------------o?----oT---------------?-?----f
mo-------oT--B-X-----X-Eo--E--Eo------E--------E---o-o-ooTE---E------XM-E--o---------------------E-oo-EE---T---EoMoT--XX---ooE-E-ooo-T------oX--X----o----T-o---T---o---X-E---X-----X---oT-ET--oE---?--X
XXXXXXXXXXXXXXXXXXXXXXXXXXXXXXXXXXXXXX-XXXXXXXXXX-XXXXXXXXXXXXXXXXXXXXXXXXXXXXX-XXXXXXXXXXXX--XXXXXXXXXXXXXX-XXXXXXXXXX-XXXXXXXXXXXXXXXXXXXX-XXXXXXXXXXXXXXXXXXXXXXXXXXXXXXXXXXXXXXXXXXX-XXXXXXXXXX-XXXX
