--------------------------------------------------------------------------------------------------------------------------------------------------------------------------------------------------------
--------------------------------------------------------------------------------------------------------------------------------------------------------------------------------------------------------
--------------------------------------------------------------------------------------------------------------------------------------------------------------------------------------------------------
-B---Bo-----oo--o-oM-?-M-----------?----?M--------?-B-----o----------------------M----M---o--o-------o------------B-M---?-o----?-----?o-?-?--X-------------?B--oM------?--M------o---------o-o-----M-M--
----?o---M--------------o--o---B---o-M----------B------o?-?--?-?MB------?---??-----?-----MMM--B--------------?------o?-?----M-----B---M----?--o-----?--------B-B--?--------M--------B?-----M----M---?---
-o----------?--o-o-----M-----------M------?---------oM----o---o------oo-----------o-M-Bo---------B--?-----------------?----B--?M----M-----?--------------B--M-------o--------B-M--------?--o--?B--o-----
---?-----?-------oo------o---E---B--MB---?-------M-B----Mo-B-o--------o----?----?---------B-----?-------oM-------M---?-?-----o-------M-----oo---M-?---------oM--o-Mo-------------B--------o--M----?-----
-?-o-----------o-----B?--------BB----------------------------BB--------?------B-----?B---?o--MM-----M-M---------------------M?---------oM-ooM-?M------o-M-----?----?---------M-M----------?----M--o----v
----------M---B---MB---?o-------o------------MB?----B--------------M?---------------o--B?--?--o-o---o-----?-MB----?-----??--------M----------------------oM-----M-------------------?------?--?----?---f
----o----?-----o------oo-----o---M---?-M---o------M---MM-oM?-?-?o------?--o-E------M-----o------o---M-M--oo----??---------?o----o------M---M---?-----?------?-------o---o--?-----M-o--M------------oM--f
-B--?-o---M--M------oo---?--?--------------o-----------oB?------------------?--?------B---M-?o--M--------M----oo-M-o-------B-M-----------?o-?-o-M---------?----?--M----?-----------oM-----B-o----?-----f
---------B--o-?-E----?-------M-B----o------o-----M--?--?-------?---?ooB-?--?--M-o--------------------??B-------M--o-MM??-B?---------o------------oB-M--B----B-M----M?---------??------B?M-----?----B---f
--o---B---------M----------?--?-----B-?M--M---M-------?----M-----M---?------M--?--oB---M----BBo---?-----o----------------------------------M-------------?------?-M-----B---o--------B-o----B--M-----o-f
--o-----------o----------------------------------o-----------------------------------------------------------------------o---------------o-------------------------------------------------------------f
m-o---------------------o---------X-------------oX-------o---------------------------oo------o--------T---------------X-------------o-o----------------------------E-o-------o---------------X--X------X
XXXXXXXXXXXXXXXXXXXXXXXXXXXXXXXXXXXXXXXXXXXX-XXXXXXXXXXXXXXXXXXXXXXXXXXXX-XXXXXXXXXXXXXXXXXXXXXXXXXXXXXXXXXXXXXX-XXXXXXXXXXXXXXX-XXXXXXXXXXXXXXXXXXXXX-XXXXXXXXXXXXXXXXXXXXXXXXXXXXXXXXXXXXXXXXXXXXXXXXX
